*********** # 1 **************
PokerStars Zoom Hand #174049627323:  Hold'em No Limit ($0.02/$0.05) - 2017/08/07 23:59:46 MSK [2017/08/07 16:59:46 ET]
Table 'Donati' 6-max Seat #1 is the button
Seat 1: B0GEYMAN ($8.09 in chips)
Seat 2: Majkee88 ($21.52 in chips)
Seat 3: Anton Tr ($5.88 in chips)
Seat 4: lucky_gabbi ($2.88 in chips)
Seat 5: validosha ($2.58 in chips)
Seat 6: Baksojor ($5.95 in chips)
Majkee88: posts small blind $0.02
Anton Tr: posts big blind $0.05
*** HOLE CARDS ***
Dealt to Baksojor [5s 6h]
lucky_gabbi: raises $0.10 to $0.15
validosha: folds
Baksojor: folds
B0GEYMAN: folds
Majkee88: folds
Anton Tr: folds
Uncalled bet ($0.10) returned to lucky_gabbi
lucky_gabbi collected $0.12 from pot
lucky_gabbi: doesn't show hand
*** SUMMARY ***
Total pot $0.12 | Rake $0
Seat 1: B0GEYMAN (button) folded before Flop (didn't bet)
Seat 2: Majkee88 (small blind) folded before Flop
Seat 3: Anton Tr (big blind) folded before Flop
Seat 4: lucky_gabbi collected ($0.12)
Seat 5: validosha folded before Flop (didn't bet)
Seat 6: Baksojor folded before Flop (didn't bet)


*********** # 2 **************
PokerStars Zoom Hand #174049616056:  Hold'em No Limit ($0.02/$0.05) - 2017/08/07 23:59:28 MSK [2017/08/07 16:59:28 ET]
Table 'Donati' 6-max Seat #1 is the button
Seat 1: Baksojor ($5.95 in chips)
Seat 2: hen1337 ($8.92 in chips)
Seat 3: mmegan92 ($11.89 in chips)
Seat 4: Girigal ($5.70 in chips)
Seat 5: chraeder ($3.80 in chips)
Seat 6: Pahuljica37 ($5.46 in chips)
hen1337: posts small blind $0.02
mmegan92: posts big blind $0.05
*** HOLE CARDS ***
Dealt to Baksojor [Ts 8d]
Girigal: folds
chraeder: raises $0.07 to $0.12
Pahuljica37: folds
Baksojor: folds
hen1337: folds
mmegan92: folds
Uncalled bet ($0.07) returned to chraeder
chraeder collected $0.12 from pot
chraeder: doesn't show hand
*** SUMMARY ***
Total pot $0.12 | Rake $0
Seat 1: Baksojor (button) folded before Flop (didn't bet)
Seat 2: hen1337 (small blind) folded before Flop
Seat 3: mmegan92 (big blind) folded before Flop
Seat 4: Girigal folded before Flop (didn't bet)
Seat 5: chraeder collected ($0.12)
Seat 6: Pahuljica37 folded before Flop (didn't bet)


*********** # 3 **************
PokerStars Zoom Hand #174049574653:  Hold'em No Limit ($0.02/$0.05) - 2017/08/07 23:58:23 MSK [2017/08/07 16:58:23 ET]
Table 'Donati' 6-max Seat #1 is the button
Seat 1: IldarD86 ($7.73 in chips)
Seat 2: Taron-gao ($6.30 in chips)
Seat 3: 777serg58 ($6.43 in chips)
Seat 4: Baksojor ($12.25 in chips)
Seat 5: Sviat47 ($6.53 in chips)
Seat 6: Levmachinexx ($11.46 in chips)
Taron-gao: posts small blind $0.02
777serg58: posts big blind $0.05
*** HOLE CARDS ***
Dealt to Baksojor [Kc Ks]
Baksojor: raises $0.10 to $0.15
Sviat47: folds
Levmachinexx: folds
IldarD86: folds
Taron-gao: calls $0.13
777serg58: folds
*** FLOP *** [6h 5c Qc]
Taron-gao: bets $0.20
Baksojor: raises $0.45 to $0.65
Taron-gao: raises $0.95 to $1.60
Baksojor: calls $0.95
*** TURN *** [6h 5c Qc] [7d]
Taron-gao: bets $4.55 and is all-in
Baksojor: calls $4.55
*** RIVER *** [6h 5c Qc 7d] [4c]
*** SHOW DOWN ***
Taron-gao: shows [8h 9h] (a straight, Five to Nine)
Baksojor: shows [Kc Ks] (a pair of Kings)
Taron-gao collected $12.13 from pot
*** SUMMARY ***
Total pot $12.65 | Rake $0.52
Board [6h 5c Qc 7d 4c]
Seat 1: IldarD86 (button) folded before Flop (didn't bet)
Seat 2: Taron-gao (small blind) showed [8h 9h] and won ($12.13) with a straight, Five to Nine
Seat 3: 777serg58 (big blind) folded before Flop
Seat 4: Baksojor showed [Kc Ks] and lost with a pair of Kings
Seat 5: Sviat47 folded before Flop (didn't bet)
Seat 6: Levmachinexx folded before Flop (didn't bet)


*********** # 4 **************
PokerStars Zoom Hand #174049565191:  Hold'em No Limit ($0.02/$0.05) - 2017/08/07 23:58:08 MSK [2017/08/07 16:58:08 ET]
Table 'Donati' 6-max Seat #1 is the button
Seat 1: Naosky ($6.25 in chips)
Seat 2: InteRus13 ($4.88 in chips)
Seat 3: Baksojor ($12.23 in chips)
Seat 4: legitspade12 ($11.02 in chips)
Seat 5: Sabarakk ($6.02 in chips)
Seat 6: eduardogod ($6.28 in chips)
InteRus13: posts small blind $0.02
Baksojor: posts big blind $0.05
*** HOLE CARDS ***
Dealt to Baksojor [Ts Ks]
legitspade12: folds
Sabarakk: folds
eduardogod: folds
Naosky: folds
InteRus13: folds
Uncalled bet ($0.03) returned to Baksojor
Baksojor collected $0.04 from pot
Baksojor: doesn't show hand
*** SUMMARY ***
Total pot $0.04 | Rake $0
Seat 1: Naosky (button) folded before Flop (didn't bet)
Seat 2: InteRus13 (small blind) folded before Flop
Seat 3: Baksojor (big blind) collected ($0.04)
Seat 4: legitspade12 folded before Flop (didn't bet)
Seat 5: Sabarakk folded before Flop (didn't bet)
Seat 6: eduardogod folded before Flop (didn't bet)


*********** # 5 **************
PokerStars Zoom Hand #174049561423:  Hold'em No Limit ($0.02/$0.05) - 2017/08/07 23:58:02 MSK [2017/08/07 16:58:02 ET]
Table 'Donati' 6-max Seat #1 is the button
Seat 1: duniy ($12.32 in chips)
Seat 2: Baksojor ($12.25 in chips)
Seat 3: Sviat47 ($6.38 in chips)
Seat 4: Lina6591 ($2.48 in chips)
Seat 5: felipe_anps ($5 in chips)
Seat 6: macedow ($5.60 in chips)
Baksojor: posts small blind $0.02
Sviat47: posts big blind $0.05
*** HOLE CARDS ***
Dealt to Baksojor [7s Kh]
Lina6591: raises $0.05 to $0.10
felipe_anps: folds
macedow: folds
duniy: folds
Baksojor: folds
Sviat47: calls $0.05
*** FLOP *** [Jd 9c 4s]
Sviat47: checks
Lina6591: bets $0.11
Sviat47: raises $0.23 to $0.34
Lina6591: calls $0.23
*** TURN *** [Jd 9c 4s] [5c]
Sviat47: checks
Lina6591: bets $0.43
Sviat47: folds
Uncalled bet ($0.43) returned to Lina6591
Lina6591 collected $0.86 from pot
Lina6591: doesn't show hand
*** SUMMARY ***
Total pot $0.90 | Rake $0.04
Board [Jd 9c 4s 5c]
Seat 1: duniy (button) folded before Flop (didn't bet)
Seat 2: Baksojor (small blind) folded before Flop
Seat 3: Sviat47 (big blind) folded on the Turn
Seat 4: Lina6591 collected ($0.86)
Seat 5: felipe_anps folded before Flop (didn't bet)
Seat 6: macedow folded before Flop (didn't bet)


*********** # 6 **************
PokerStars Zoom Hand #174049550624:  Hold'em No Limit ($0.02/$0.05) - 2017/08/07 23:57:45 MSK [2017/08/07 16:57:45 ET]
Table 'Donati' 6-max Seat #1 is the button
Seat 1: Baksojor ($12.25 in chips)
Seat 2: williamnik ($12.42 in chips)
Seat 3: Sathar123 ($9.14 in chips)
Seat 4: AndreyK11 ($14.60 in chips)
Seat 5: andrej601 ($5.04 in chips)
Seat 6: IVE244 ($5.18 in chips)
williamnik: posts small blind $0.02
Sathar123: posts big blind $0.05
*** HOLE CARDS ***
Dealt to Baksojor [6d Ac]
AndreyK11: folds
andrej601: folds
IVE244: raises $0.07 to $0.12
Baksojor: folds
williamnik: folds
Sathar123: folds
Uncalled bet ($0.07) returned to IVE244
IVE244 collected $0.12 from pot
IVE244: doesn't show hand
*** SUMMARY ***
Total pot $0.12 | Rake $0
Seat 1: Baksojor (button) folded before Flop (didn't bet)
Seat 2: williamnik (small blind) folded before Flop
Seat 3: Sathar123 (big blind) folded before Flop
Seat 4: AndreyK11 folded before Flop (didn't bet)
Seat 5: andrej601 folded before Flop (didn't bet)
Seat 6: IVE244 collected ($0.12)


*********** # 7 **************
PokerStars Zoom Hand #174049548128:  Hold'em No Limit ($0.02/$0.05) - 2017/08/07 23:57:41 MSK [2017/08/07 16:57:41 ET]
Table 'Donati' 6-max Seat #1 is the button
Seat 1: TristanWPA ($2.57 in chips)
Seat 2: and_67rus ($4.40 in chips)
Seat 3: bajinege ($9.11 in chips)
Seat 4: donn1987 ($2.60 in chips)
Seat 5: Baksojor ($12.25 in chips)
Seat 6: qk rodriguez ($5.38 in chips)
and_67rus: posts small blind $0.02
bajinege: posts big blind $0.05
*** HOLE CARDS ***
Dealt to Baksojor [8c 5h]
donn1987: raises $0.10 to $0.15
Baksojor: folds
qk rodriguez: folds
TristanWPA: folds
and_67rus: raises $0.35 to $0.50
bajinege: folds
donn1987: calls $0.35
*** FLOP *** [Ah 3c Ac]
and_67rus: bets $0.40
donn1987: raises $0.40 to $0.80
and_67rus: folds
Uncalled bet ($0.40) returned to donn1987
donn1987 collected $1.77 from pot
donn1987: doesn't show hand
*** SUMMARY ***
Total pot $1.85 | Rake $0.08
Board [Ah 3c Ac]
Seat 1: TristanWPA (button) folded before Flop (didn't bet)
Seat 2: and_67rus (small blind) folded on the Flop
Seat 3: bajinege (big blind) folded before Flop
Seat 4: donn1987 collected ($1.77)
Seat 5: Baksojor folded before Flop (didn't bet)
Seat 6: qk rodriguez folded before Flop (didn't bet)


*********** # 8 **************
PokerStars Zoom Hand #174049544975:  Hold'em No Limit ($0.02/$0.05) - 2017/08/07 23:57:36 MSK [2017/08/07 16:57:36 ET]
Table 'Donati' 6-max Seat #1 is the button
Seat 1: MárioRJ ($7.09 in chips)
Seat 2: Dasha_1989 ($5 in chips)
Seat 3: My4Street ($8.26 in chips)
Seat 4: Baksojor ($12.25 in chips)
Seat 5: andypr0 ($17.94 in chips)
Seat 6: Fuerste2508 ($5.15 in chips)
Dasha_1989: posts small blind $0.02
My4Street: posts big blind $0.05
*** HOLE CARDS ***
Dealt to Baksojor [9s 7s]
Baksojor: folds
andypr0: folds
Fuerste2508: folds
MárioRJ: raises $0.10 to $0.15
Dasha_1989: folds
My4Street: folds
Uncalled bet ($0.10) returned to MárioRJ
MárioRJ collected $0.12 from pot
MárioRJ: doesn't show hand
*** SUMMARY ***
Total pot $0.12 | Rake $0
Seat 1: MárioRJ (button) collected ($0.12)
Seat 2: Dasha_1989 (small blind) folded before Flop
Seat 3: My4Street (big blind) folded before Flop
Seat 4: Baksojor folded before Flop (didn't bet)
Seat 5: andypr0 folded before Flop (didn't bet)
Seat 6: Fuerste2508 folded before Flop (didn't bet)


*********** # 9 **************
PokerStars Zoom Hand #174049532009:  Hold'em No Limit ($0.02/$0.05) - 2017/08/07 23:57:24 MSK [2017/08/07 16:57:24 ET]
Table 'Donati' 6-max Seat #1 is the button
Seat 1: rei785 ($2.32 in chips)
Seat 2: Demon31222 ($6.26 in chips)
Seat 3: Baksojor ($12.30 in chips)
Seat 4: mnorde ($7.16 in chips)
Seat 5: balibalzow ($5.25 in chips)
Seat 6: guilhermev85 ($5.14 in chips)
Demon31222: posts small blind $0.02
Baksojor: posts big blind $0.05
*** HOLE CARDS ***
Dealt to Baksojor [2c 5c]
mnorde: folds
balibalzow: folds
guilhermev85: raises $0.10 to $0.15
rei785: calls $0.15
Demon31222: folds
Baksojor: folds
*** FLOP *** [4h 7d 6d]
guilhermev85: checks
rei785: bets $0.20
guilhermev85: calls $0.20
*** TURN *** [4h 7d 6d] [8s]
guilhermev85: checks
rei785: checks
*** RIVER *** [4h 7d 6d 8s] [Js]
guilhermev85: checks
rei785: checks
*** SHOW DOWN ***
guilhermev85: shows [Kc Ah] (high card Ace)
rei785: shows [7c Ad] (a pair of Sevens)
rei785 collected $0.74 from pot
*** SUMMARY ***
Total pot $0.77 | Rake $0.03
Board [4h 7d 6d 8s Js]
Seat 1: rei785 (button) showed [7c Ad] and won ($0.74) with a pair of Sevens
Seat 2: Demon31222 (small blind) folded before Flop
Seat 3: Baksojor (big blind) folded before Flop
Seat 4: mnorde folded before Flop (didn't bet)
Seat 5: balibalzow folded before Flop (didn't bet)
Seat 6: guilhermev85 showed [Kc Ah] and lost with high card Ace


*********** # 10 **************
PokerStars Zoom Hand #174049522525:  Hold'em No Limit ($0.02/$0.05) - 2017/08/07 23:57:09 MSK [2017/08/07 16:57:09 ET]
Table 'Donati' 6-max Seat #1 is the button
Seat 1: Oscar__62176 ($11.18 in chips)
Seat 2: YstrAV ($33.45 in chips)
Seat 3: grant8064 ($5.20 in chips)
Seat 4: InteRus13 ($5.82 in chips)
Seat 5: Baksojor ($12.30 in chips)
Seat 6: Monsterpot13 ($4.26 in chips)
YstrAV: posts small blind $0.02
grant8064: posts big blind $0.05
*** HOLE CARDS ***
Dealt to Baksojor [Qs Jh]
InteRus13: folds
Baksojor: folds
Monsterpot13: folds
Oscar__62176: folds
YstrAV: folds
Uncalled bet ($0.03) returned to grant8064
grant8064 collected $0.04 from pot
grant8064: doesn't show hand
*** SUMMARY ***
Total pot $0.04 | Rake $0
Seat 1: Oscar__62176 (button) folded before Flop (didn't bet)
Seat 2: YstrAV (small blind) folded before Flop
Seat 3: grant8064 (big blind) collected ($0.04)
Seat 4: InteRus13 folded before Flop (didn't bet)
Seat 5: Baksojor folded before Flop (didn't bet)
Seat 6: Monsterpot13 folded before Flop (didn't bet)


*********** # 11 **************
PokerStars Zoom Hand #174049511667:  Hold'em No Limit ($0.02/$0.05) - 2017/08/07 23:56:52 MSK [2017/08/07 16:56:52 ET]
Table 'Donati' 6-max Seat #1 is the button
Seat 1: MárioRJ ($9.40 in chips)
Seat 2: delgadolisto ($8.82 in chips)
Seat 3: ElbowsKnees ($5 in chips)
Seat 4: S2M3R4Kac ($3.03 in chips)
Seat 5: freddy2704 ($4.83 in chips)
Seat 6: Baksojor ($12.23 in chips)
delgadolisto: posts small blind $0.02
ElbowsKnees: posts big blind $0.05
*** HOLE CARDS ***
Dealt to Baksojor [8h 8d]
S2M3R4Kac: folds
freddy2704: folds
Baksojor: raises $0.07 to $0.12
MárioRJ: folds
delgadolisto: folds
ElbowsKnees: folds
Uncalled bet ($0.07) returned to Baksojor
Baksojor collected $0.12 from pot
Baksojor: doesn't show hand
*** SUMMARY ***
Total pot $0.12 | Rake $0
Seat 1: MárioRJ (button) folded before Flop (didn't bet)
Seat 2: delgadolisto (small blind) folded before Flop
Seat 3: ElbowsKnees (big blind) folded before Flop
Seat 4: S2M3R4Kac folded before Flop (didn't bet)
Seat 5: freddy2704 folded before Flop (didn't bet)
Seat 6: Baksojor collected ($0.12)


*********** # 12 **************
PokerStars Zoom Hand #174049506629:  Hold'em No Limit ($0.02/$0.05) - 2017/08/07 23:56:44 MSK [2017/08/07 16:56:44 ET]
Table 'Donati' 6-max Seat #1 is the button
Seat 1: Baksojor ($12.23 in chips)
Seat 2: Ara7193 ($2.43 in chips)
Seat 3: MakeMyD@y ($6.93 in chips)
Seat 4: felipe_anps ($7.56 in chips)
Seat 5: DiBully ($4.93 in chips)
Seat 6: nacrenac1994 ($3.14 in chips)
Ara7193: posts small blind $0.02
MakeMyD@y: posts big blind $0.05
*** HOLE CARDS ***
Dealt to Baksojor [Ks 3s]
felipe_anps: folds
DiBully: raises $0.10 to $0.15
nacrenac1994: folds
Baksojor: folds
Ara7193: calls $0.13
MakeMyD@y: folds
*** FLOP *** [5d 6d Jh]
Ara7193: checks
DiBully: bets $0.17
Ara7193: raises $0.17 to $0.34
DiBully: folds
Uncalled bet ($0.17) returned to Ara7193
Ara7193 collected $0.66 from pot
Ara7193: doesn't show hand
*** SUMMARY ***
Total pot $0.69 | Rake $0.03
Board [5d 6d Jh]
Seat 1: Baksojor (button) folded before Flop (didn't bet)
Seat 2: Ara7193 (small blind) collected ($0.66)
Seat 3: MakeMyD@y (big blind) folded before Flop
Seat 4: felipe_anps folded before Flop (didn't bet)
Seat 5: DiBully folded on the Flop
Seat 6: nacrenac1994 folded before Flop (didn't bet)


*********** # 13 **************
PokerStars Zoom Hand #174049504066:  Hold'em No Limit ($0.02/$0.05) - 2017/08/07 23:56:40 MSK [2017/08/07 16:56:40 ET]
Table 'Donati' 6-max Seat #1 is the button
Seat 1: LuckyIldar ($18.43 in chips)
Seat 2: Baksojor ($12.25 in chips)
Seat 3: AndreyK11 ($5 in chips)
Seat 4: schredinger ($3.36 in chips)
Seat 5: YmanB ($4.83 in chips)
Seat 6: omgitsslave ($10.91 in chips)
Baksojor: posts small blind $0.02
AndreyK11: posts big blind $0.05
*** HOLE CARDS ***
Dealt to Baksojor [5h 8d]
schredinger: folds
YmanB: folds
omgitsslave: raises $0.09 to $0.14
LuckyIldar: folds
Baksojor: folds
AndreyK11: folds
Uncalled bet ($0.09) returned to omgitsslave
omgitsslave collected $0.12 from pot
omgitsslave: doesn't show hand
*** SUMMARY ***
Total pot $0.12 | Rake $0
Seat 1: LuckyIldar (button) folded before Flop (didn't bet)
Seat 2: Baksojor (small blind) folded before Flop
Seat 3: AndreyK11 (big blind) folded before Flop
Seat 4: schredinger folded before Flop (didn't bet)
Seat 5: YmanB folded before Flop (didn't bet)
Seat 6: omgitsslave collected ($0.12)


*********** # 14 **************
PokerStars Zoom Hand #174049482538:  Hold'em No Limit ($0.02/$0.05) - 2017/08/07 23:56:06 MSK [2017/08/07 16:56:06 ET]
Table 'Donati' 6-max Seat #1 is the button
Seat 1: jeliax ($6.63 in chips)
Seat 2: Igor22913 ($5.16 in chips)
Seat 3: Luca$$$ino ($3.03 in chips)
Seat 4: Girigal ($5 in chips)
Seat 5: romanshepp ($5.87 in chips)
Seat 6: Baksojor ($12.12 in chips)
Igor22913: posts small blind $0.02
Luca$$$ino: posts big blind $0.05
*** HOLE CARDS ***
Dealt to Baksojor [Td 9d]
Girigal: folds
romanshepp: folds
Baksojor: raises $0.07 to $0.12
jeliax: folds
Igor22913: folds
Luca$$$ino: calls $0.07
*** FLOP *** [3c As 2d]
Luca$$$ino: checks
Baksojor: bets $0.13
Luca$$$ino: folds
Uncalled bet ($0.13) returned to Baksojor
Baksojor collected $0.25 from pot
Baksojor: doesn't show hand
*** SUMMARY ***
Total pot $0.26 | Rake $0.01
Board [3c As 2d]
Seat 1: jeliax (button) folded before Flop (didn't bet)
Seat 2: Igor22913 (small blind) folded before Flop
Seat 3: Luca$$$ino (big blind) folded on the Flop
Seat 4: Girigal folded before Flop (didn't bet)
Seat 5: romanshepp folded before Flop (didn't bet)
Seat 6: Baksojor collected ($0.25)


*********** # 15 **************
PokerStars Zoom Hand #174049478004:  Hold'em No Limit ($0.02/$0.05) - 2017/08/07 23:55:59 MSK [2017/08/07 16:55:59 ET]
Table 'Donati' 6-max Seat #1 is the button
Seat 1: 999Monstr999 ($4.24 in chips)
Seat 2: smither83 ($7.72 in chips)
Seat 3: Baksojor ($12.17 in chips)
Seat 4: Bisi6611 ($9.53 in chips)
Seat 5: hellhippo ($5.81 in chips)
Seat 6: xizza ($13.82 in chips)
smither83: posts small blind $0.02
Baksojor: posts big blind $0.05
*** HOLE CARDS ***
Dealt to Baksojor [2c 8d]
Bisi6611: raises $0.10 to $0.15
hellhippo: folds
xizza: folds
999Monstr999: folds
smither83: folds
Baksojor: folds
Uncalled bet ($0.10) returned to Bisi6611
Bisi6611 collected $0.12 from pot
Bisi6611: doesn't show hand
*** SUMMARY ***
Total pot $0.12 | Rake $0
Seat 1: 999Monstr999 (button) folded before Flop (didn't bet)
Seat 2: smither83 (small blind) folded before Flop
Seat 3: Baksojor (big blind) folded before Flop
Seat 4: Bisi6611 collected ($0.12)
Seat 5: hellhippo folded before Flop (didn't bet)
Seat 6: xizza folded before Flop (didn't bet)


*********** # 16 **************
PokerStars Zoom Hand #174049473593:  Hold'em No Limit ($0.02/$0.05) - 2017/08/07 23:55:52 MSK [2017/08/07 16:55:52 ET]
Table 'Donati' 6-max Seat #1 is the button
Seat 1: C0mm4nder44 ($6.06 in chips)
Seat 2: Baksojor ($12.19 in chips)
Seat 3: dimon36krut ($5.81 in chips)
Seat 4: Darkymond ($5.52 in chips)
Seat 5: Aleks Ryder ($9.23 in chips)
Seat 6: YmanB ($5.21 in chips)
Baksojor: posts small blind $0.02
dimon36krut: posts big blind $0.05
*** HOLE CARDS ***
Dealt to Baksojor [7h 6d]
Darkymond: folds
Aleks Ryder: folds
YmanB: folds
C0mm4nder44: folds
Baksojor: folds
Uncalled bet ($0.03) returned to dimon36krut
dimon36krut collected $0.04 from pot
dimon36krut: doesn't show hand
*** SUMMARY ***
Total pot $0.04 | Rake $0
Seat 1: C0mm4nder44 (button) folded before Flop (didn't bet)
Seat 2: Baksojor (small blind) folded before Flop
Seat 3: dimon36krut (big blind) collected ($0.04)
Seat 4: Darkymond folded before Flop (didn't bet)
Seat 5: Aleks Ryder folded before Flop (didn't bet)
Seat 6: YmanB folded before Flop (didn't bet)


*********** # 17 **************
PokerStars Zoom Hand #174049470986:  Hold'em No Limit ($0.02/$0.05) - 2017/08/07 23:55:48 MSK [2017/08/07 16:55:48 ET]
Table 'Donati' 6-max Seat #1 is the button
Seat 1: smither83 ($7.72 in chips)
Seat 2: omgitsslave ($5.34 in chips)
Seat 3: qk rodriguez ($6.52 in chips)
Seat 4: Baksojor ($12.19 in chips)
Seat 5: vasiasul11 ($12.06 in chips)
Seat 6: MrInTerra ($5.45 in chips)
omgitsslave: posts small blind $0.02
qk rodriguez: posts big blind $0.05
*** HOLE CARDS ***
Dealt to Baksojor [5c Qd]
Baksojor: folds
vasiasul11: raises $0.05 to $0.10
MrInTerra: folds
smither83: folds
omgitsslave: folds
qk rodriguez: folds
Uncalled bet ($0.05) returned to vasiasul11
vasiasul11 collected $0.12 from pot
vasiasul11: doesn't show hand
*** SUMMARY ***
Total pot $0.12 | Rake $0
Seat 1: smither83 (button) folded before Flop (didn't bet)
Seat 2: omgitsslave (small blind) folded before Flop
Seat 3: qk rodriguez (big blind) folded before Flop
Seat 4: Baksojor folded before Flop (didn't bet)
Seat 5: vasiasul11 collected ($0.12)
Seat 6: MrInTerra folded before Flop (didn't bet)


*********** # 18 **************
PokerStars Zoom Hand #174049465361:  Hold'em No Limit ($0.02/$0.05) - 2017/08/07 23:55:39 MSK [2017/08/07 16:55:39 ET]
Table 'Donati' 6-max Seat #1 is the button
Seat 1: williamnik ($13.06 in chips)
Seat 2: Girigal ($5.68 in chips)
Seat 3: romanshepp ($7.82 in chips)
Seat 4: Stingray31 ($5.37 in chips)
Seat 5: Baksojor ($12.19 in chips)
Seat 6: FINTIFLYSHKI ($0.83 in chips)
Girigal: posts small blind $0.02
romanshepp: posts big blind $0.05
*** HOLE CARDS ***
Dealt to Baksojor [8c 7h]
Stingray31: folds
Baksojor: folds
FINTIFLYSHKI: folds
williamnik: folds
Girigal: raises $0.10 to $0.15
romanshepp: folds
Uncalled bet ($0.10) returned to Girigal
Girigal collected $0.10 from pot
Girigal: doesn't show hand
*** SUMMARY ***
Total pot $0.10 | Rake $0
Seat 1: williamnik (button) folded before Flop (didn't bet)
Seat 2: Girigal (small blind) collected ($0.10)
Seat 3: romanshepp (big blind) folded before Flop
Seat 4: Stingray31 folded before Flop (didn't bet)
Seat 5: Baksojor folded before Flop (didn't bet)
Seat 6: FINTIFLYSHKI folded before Flop (didn't bet)


*********** # 19 **************
PokerStars Zoom Hand #174049460980:  Hold'em No Limit ($0.02/$0.05) - 2017/08/07 23:55:32 MSK [2017/08/07 16:55:32 ET]
Table 'Donati' 6-max Seat #1 is the button
Seat 1: Baksojor ($12.19 in chips)
Seat 2: FAHHH168 ($5.22 in chips)
Seat 3: maxtel5 ($5.69 in chips)
Seat 4: atlandhia ($2.78 in chips)
Seat 5: gameflix ($7.04 in chips)
Seat 6: goldbunnies ($6.08 in chips)
FAHHH168: posts small blind $0.02
maxtel5: posts big blind $0.05
*** HOLE CARDS ***
Dealt to Baksojor [5d Th]
atlandhia: calls $0.05
gameflix: raises $0.15 to $0.20
goldbunnies: folds
Baksojor: folds
FAHHH168: folds
maxtel5: folds
atlandhia: calls $0.15
*** FLOP *** [Jc 6c 2c]
atlandhia: checks
gameflix: bets $0.30
atlandhia: folds
Uncalled bet ($0.30) returned to gameflix
gameflix collected $0.45 from pot
gameflix: doesn't show hand
*** SUMMARY ***
Total pot $0.47 | Rake $0.02
Board [Jc 6c 2c]
Seat 1: Baksojor (button) folded before Flop (didn't bet)
Seat 2: FAHHH168 (small blind) folded before Flop
Seat 3: maxtel5 (big blind) folded before Flop
Seat 4: atlandhia folded on the Flop
Seat 5: gameflix collected ($0.45)
Seat 6: goldbunnies folded before Flop (didn't bet)


*********** # 20 **************
PokerStars Zoom Hand #174049455979:  Hold'em No Limit ($0.02/$0.05) - 2017/08/07 23:55:24 MSK [2017/08/07 16:55:24 ET]
Table 'Donati' 6-max Seat #1 is the button
Seat 1: vitata67 ($5 in chips)
Seat 2: MrInTerra ($5.62 in chips)
Seat 3: nodarik1980 ($5.14 in chips)
Seat 4: Baksojor ($12.19 in chips)
Seat 5: grant8064 ($7.91 in chips)
Seat 6: InteRus13 ($4.31 in chips)
MrInTerra: posts small blind $0.02
nodarik1980: posts big blind $0.05
*** HOLE CARDS ***
Dealt to Baksojor [Jc Th]
Baksojor: folds
grant8064: folds
InteRus13: folds
vitata67: raises $0.10 to $0.15
MrInTerra: folds
nodarik1980: folds
Uncalled bet ($0.10) returned to vitata67
vitata67 collected $0.12 from pot
vitata67: doesn't show hand
*** SUMMARY ***
Total pot $0.12 | Rake $0
Seat 1: vitata67 (button) collected ($0.12)
Seat 2: MrInTerra (small blind) folded before Flop
Seat 3: nodarik1980 (big blind) folded before Flop
Seat 4: Baksojor folded before Flop (didn't bet)
Seat 5: grant8064 folded before Flop (didn't bet)
Seat 6: InteRus13 folded before Flop (didn't bet)


*********** # 21 **************
PokerStars Zoom Hand #174049406495:  Hold'em No Limit ($0.02/$0.05) - 2017/08/07 23:54:18 MSK [2017/08/07 16:54:18 ET]
Table 'Donati' 6-max Seat #1 is the button
Seat 1: Pahuljica37 ($4.28 in chips)
Seat 2: Baksojor ($17.19 in chips)
Seat 3: Lina6591 ($2.12 in chips)
Seat 4: kscloud ($4.20 in chips)
Seat 5: Hasan-i-Sabb ($2.61 in chips)
Seat 6: stano5 ($5 in chips)
Baksojor: posts small blind $0.02
Lina6591: posts big blind $0.05
*** HOLE CARDS ***
Dealt to Baksojor [Tc Td]
kscloud: folds
Hasan-i-Sabb: folds
stano5: raises $0.06 to $0.11
Pahuljica37: folds
Baksojor: raises $0.29 to $0.40
Lina6591: folds
stano5: calls $0.29
*** FLOP *** [8d 2c 9s]
Baksojor: bets $0.54
stano5: raises $0.86 to $1.40
Baksojor: raises $3.61 to $5.01
stano5: calls $3.20 and is all-in
Uncalled bet ($0.41) returned to Baksojor
*** TURN *** [8d 2c 9s] [Jc]
*** RIVER *** [8d 2c 9s Jc] [3s]
*** SHOW DOWN ***
Baksojor: shows [Tc Td] (a pair of Tens)
stano5: shows [9c 9d] (three of a kind, Nines)
stano5 collected $9.63 from pot
*** SUMMARY ***
Total pot $10.05 | Rake $0.42
Board [8d 2c 9s Jc 3s]
Seat 1: Pahuljica37 (button) folded before Flop (didn't bet)
Seat 2: Baksojor (small blind) showed [Tc Td] and lost with a pair of Tens
Seat 3: Lina6591 (big blind) folded before Flop
Seat 4: kscloud folded before Flop (didn't bet)
Seat 5: Hasan-i-Sabb folded before Flop (didn't bet)
Seat 6: stano5 showed [9c 9d] and won ($9.63) with three of a kind, Nines


*********** # 22 **************
PokerStars Zoom Hand #174049377913:  Hold'em No Limit ($0.02/$0.05) - 2017/08/07 23:53:41 MSK [2017/08/07 16:53:41 ET]
Table 'Donati' 6-max Seat #1 is the button
Seat 1: jeliax ($6.69 in chips)
Seat 2: My4Street ($10.37 in chips)
Seat 3: Baksojor ($17.30 in chips)
Seat 4: nippesboy ($6.20 in chips)
Seat 5: sunset1111 ($6.54 in chips)
Seat 6: 1matodor$ ($9.09 in chips)
My4Street: posts small blind $0.02
Baksojor: posts big blind $0.05
*** HOLE CARDS ***
Dealt to Baksojor [Th Ad]
nippesboy: folds
sunset1111: folds
1matodor$: folds
jeliax: raises $0.06 to $0.11
My4Street: folds
Baksojor: calls $0.06
*** FLOP *** [8c 7c Kd]
Baksojor: checks
jeliax: bets $0.06
Baksojor: folds
Uncalled bet ($0.06) returned to jeliax
jeliax collected $0.23 from pot
jeliax: doesn't show hand
*** SUMMARY ***
Total pot $0.24 | Rake $0.01
Board [8c 7c Kd]
Seat 1: jeliax (button) collected ($0.23)
Seat 2: My4Street (small blind) folded before Flop
Seat 3: Baksojor (big blind) folded on the Flop
Seat 4: nippesboy folded before Flop (didn't bet)
Seat 5: sunset1111 folded before Flop (didn't bet)
Seat 6: 1matodor$ folded before Flop (didn't bet)


*********** # 23 **************
PokerStars Zoom Hand #174049374779:  Hold'em No Limit ($0.02/$0.05) - 2017/08/07 23:53:37 MSK [2017/08/07 16:53:37 ET]
Table 'Donati' 6-max Seat #1 is the button
Seat 1: Dasha_1989 ($5.30 in chips)
Seat 2: YstrAV ($19.81 in chips)
Seat 3: Kolbert31 ($4.76 in chips)
Seat 4: Baksojor ($17.30 in chips)
Seat 5: Oscar__62176 ($6.60 in chips)
Seat 6: eduardogod ($5.42 in chips)
YstrAV: posts small blind $0.02
Kolbert31: posts big blind $0.05
*** HOLE CARDS ***
Dealt to Baksojor [8h 5h]
Baksojor: folds
Oscar__62176: folds
eduardogod: folds
Dasha_1989: raises $0.07 to $0.12
YstrAV: calls $0.10
Kolbert31: folds
*** FLOP *** [8d 6h Jh]
YstrAV: checks
Dasha_1989: checks
*** TURN *** [8d 6h Jh] [5c]
YstrAV: bets $0.10
Dasha_1989: folds
Uncalled bet ($0.10) returned to YstrAV
YstrAV collected $0.28 from pot
YstrAV: doesn't show hand
*** SUMMARY ***
Total pot $0.29 | Rake $0.01
Board [8d 6h Jh 5c]
Seat 1: Dasha_1989 (button) folded on the Turn
Seat 2: YstrAV (small blind) collected ($0.28)
Seat 3: Kolbert31 (big blind) folded before Flop
Seat 4: Baksojor folded before Flop (didn't bet)
Seat 5: Oscar__62176 folded before Flop (didn't bet)
Seat 6: eduardogod folded before Flop (didn't bet)


*********** # 24 **************
PokerStars Zoom Hand #174049371630:  Hold'em No Limit ($0.02/$0.05) - 2017/08/07 23:53:33 MSK [2017/08/07 16:53:33 ET]
Table 'Donati' 6-max Seat #1 is the button
Seat 1: Aleks Ryder ($39.21 in chips)
Seat 2: qk rodriguez ($9.09 in chips)
Seat 3: guilhermev85 ($5.41 in chips)
Seat 4: MSKLucky007 ($5.43 in chips)
Seat 5: hen1337 ($12.48 in chips)
Seat 6: Baksojor ($17.30 in chips)
qk rodriguez: posts small blind $0.02
guilhermev85: posts big blind $0.05
*** HOLE CARDS ***
Dealt to Baksojor [4d Kd]
MSKLucky007: folds
hen1337: folds
Baksojor: folds
Aleks Ryder: folds
qk rodriguez: raises $0.10 to $0.15
guilhermev85: raises $0.30 to $0.45
qk rodriguez: raises $0.65 to $1.10
guilhermev85: raises $4.31 to $5.41 and is all-in
qk rodriguez: calls $4.31
*** FLOP *** [7h Ts Qd]
*** TURN *** [7h Ts Qd] [Kh]
*** RIVER *** [7h Ts Qd Kh] [Ks]
*** SHOW DOWN ***
qk rodriguez: shows [Ad Ac] (two pair, Aces and Kings)
guilhermev85: shows [Qc As] (two pair, Kings and Queens)
qk rodriguez collected $10.37 from pot
*** SUMMARY ***
Total pot $10.82 | Rake $0.45
Board [7h Ts Qd Kh Ks]
Seat 1: Aleks Ryder (button) folded before Flop (didn't bet)
Seat 2: qk rodriguez (small blind) showed [Ad Ac] and won ($10.37) with two pair, Aces and Kings
Seat 3: guilhermev85 (big blind) showed [Qc As] and lost with two pair, Kings and Queens
Seat 4: MSKLucky007 folded before Flop (didn't bet)
Seat 5: hen1337 folded before Flop (didn't bet)
Seat 6: Baksojor folded before Flop (didn't bet)


*********** # 25 **************
PokerStars Zoom Hand #174049368509:  Hold'em No Limit ($0.02/$0.05) - 2017/08/07 23:53:29 MSK [2017/08/07 16:53:29 ET]
Table 'Donati' 6-max Seat #1 is the button
Seat 1: plasencia345 ($6.95 in chips)
Seat 2: zack20379 ($4.95 in chips)
Seat 3: BabyCry777 ($7.40 in chips)
Seat 4: Baksojor ($17.30 in chips)
Seat 5: valdemar803 ($2.60 in chips)
Seat 6: Dasha_1989 ($6.21 in chips)
zack20379: posts small blind $0.02
BabyCry777: posts big blind $0.05
*** HOLE CARDS ***
Dealt to Baksojor [Ad 8h]
Baksojor: folds
valdemar803: folds
Dasha_1989: folds
plasencia345: folds
zack20379: folds
Uncalled bet ($0.03) returned to BabyCry777
BabyCry777 collected $0.04 from pot
BabyCry777: doesn't show hand
*** SUMMARY ***
Total pot $0.04 | Rake $0
Seat 1: plasencia345 (button) folded before Flop (didn't bet)
Seat 2: zack20379 (small blind) folded before Flop
Seat 3: BabyCry777 (big blind) collected ($0.04)
Seat 4: Baksojor folded before Flop (didn't bet)
Seat 5: valdemar803 folded before Flop (didn't bet)
Seat 6: Dasha_1989 folded before Flop (didn't bet)


*********** # 26 **************
PokerStars Zoom Hand #174049357802:  Hold'em No Limit ($0.02/$0.05) - 2017/08/07 23:53:15 MSK [2017/08/07 16:53:15 ET]
Table 'Donati' 6-max Seat #1 is the button
Seat 1: Baksojor ($17.30 in chips)
Seat 2: jockl ($12.07 in chips)
Seat 3: indian2801 ($2.50 in chips)
Seat 4: 1matodor$ ($5.38 in chips)
Seat 5: Lina6591 ($0.98 in chips)
Seat 6: Dava 0060 ($4.52 in chips)
jockl: posts small blind $0.02
indian2801: posts big blind $0.05
*** HOLE CARDS ***
Dealt to Baksojor [8c 5d]
1matodor$: folds
Lina6591: raises $0.05 to $0.10
Dava 0060: raises $0.27 to $0.37
Baksojor: folds
jockl: folds
indian2801: folds
Lina6591: calls $0.27
*** FLOP *** [Ks 3d Jc]
Lina6591: checks
Dava 0060: checks
*** TURN *** [Ks 3d Jc] [2d]
Lina6591: checks
Dava 0060: checks
*** RIVER *** [Ks 3d Jc 2d] [3c]
Lina6591: checks
Dava 0060: bets $0.39
Lina6591: folds
Uncalled bet ($0.39) returned to Dava 0060
Dava 0060 collected $0.78 from pot
Dava 0060: doesn't show hand
*** SUMMARY ***
Total pot $0.81 | Rake $0.03
Board [Ks 3d Jc 2d 3c]
Seat 1: Baksojor (button) folded before Flop (didn't bet)
Seat 2: jockl (small blind) folded before Flop
Seat 3: indian2801 (big blind) folded before Flop
Seat 4: 1matodor$ folded before Flop (didn't bet)
Seat 5: Lina6591 folded on the River
Seat 6: Dava 0060 collected ($0.78)


*********** # 27 **************
PokerStars Zoom Hand #174049354700:  Hold'em No Limit ($0.02/$0.05) - 2017/08/07 23:53:11 MSK [2017/08/07 16:53:11 ET]
Table 'Donati' 6-max Seat #1 is the button
Seat 1: labus80n ($10.30 in chips)
Seat 2: IldarD86 ($8.13 in chips)
Seat 3: Pahuljica37 ($5.28 in chips)
Seat 4: Mikaeus ($5.20 in chips)
Seat 5: gesa.lienhop ($5.69 in chips)
Seat 6: Baksojor ($17.30 in chips)
IldarD86: posts small blind $0.02
Pahuljica37: posts big blind $0.05
*** HOLE CARDS ***
Dealt to Baksojor [Qh 2c]
Mikaeus: folds
gesa.lienhop: folds
Baksojor: folds
labus80n: folds
IldarD86: folds
Uncalled bet ($0.03) returned to Pahuljica37
Pahuljica37 collected $0.04 from pot
Pahuljica37: doesn't show hand
*** SUMMARY ***
Total pot $0.04 | Rake $0
Seat 1: labus80n (button) folded before Flop (didn't bet)
Seat 2: IldarD86 (small blind) folded before Flop
Seat 3: Pahuljica37 (big blind) collected ($0.04)
Seat 4: Mikaeus folded before Flop (didn't bet)
Seat 5: gesa.lienhop folded before Flop (didn't bet)
Seat 6: Baksojor folded before Flop (didn't bet)


*********** # 28 **************
PokerStars Zoom Hand #174049342328:  Hold'em No Limit ($0.02/$0.05) - 2017/08/07 23:52:55 MSK [2017/08/07 16:52:55 ET]
Table 'Donati' 6-max Seat #1 is the button
Seat 1: Toffsla ($11.38 in chips)
Seat 2: Taron-gao ($5.24 in chips)
Seat 3: Baksojor ($17.35 in chips)
Seat 4: FINTIFLYSHKI ($4.75 in chips)
Seat 5: Friadent ($5.88 in chips)
Seat 6: Droncha ($15.94 in chips)
Taron-gao: posts small blind $0.02
Baksojor: posts big blind $0.05
*** HOLE CARDS ***
Dealt to Baksojor [2c 4c]
FINTIFLYSHKI: folds
Friadent: folds
Droncha: folds
Toffsla: folds
Taron-gao: raises $0.10 to $0.15
Baksojor: folds
Uncalled bet ($0.10) returned to Taron-gao
Taron-gao collected $0.10 from pot
Taron-gao: doesn't show hand
*** SUMMARY ***
Total pot $0.10 | Rake $0
Seat 1: Toffsla (button) folded before Flop (didn't bet)
Seat 2: Taron-gao (small blind) collected ($0.10)
Seat 3: Baksojor (big blind) folded before Flop
Seat 4: FINTIFLYSHKI folded before Flop (didn't bet)
Seat 5: Friadent folded before Flop (didn't bet)
Seat 6: Droncha folded before Flop (didn't bet)


*********** # 29 **************
PokerStars Zoom Hand #174049336153:  Hold'em No Limit ($0.02/$0.05) - 2017/08/07 23:52:47 MSK [2017/08/07 16:52:47 ET]
Table 'Donati' 6-max Seat #1 is the button
Seat 1: qk rodriguez ($6.54 in chips)
Seat 2: Baksojor ($17.37 in chips)
Seat 3: Dimexp ($3.69 in chips)
Seat 4: JFJQ ($2.86 in chips)
Seat 5: Hell Knife ($5 in chips)
Seat 6: gambler4f ($13.48 in chips)
Baksojor: posts small blind $0.02
Dimexp: posts big blind $0.05
*** HOLE CARDS ***
Dealt to Baksojor [7c 2s]
JFJQ: folds
Hell Knife: folds
gambler4f: raises $0.06 to $0.11
qk rodriguez: folds
Baksojor: folds
Dimexp: calls $0.06
*** FLOP *** [Td Ah Kc]
Dimexp: checks
gambler4f: bets $0.17
Dimexp: raises $0.17 to $0.34
gambler4f: raises $0.50 to $0.84
Dimexp: calls $0.50
*** TURN *** [Td Ah Kc] [9s]
Dimexp: bets $0.90
gambler4f: calls $0.90
*** RIVER *** [Td Ah Kc 9s] [8c]
Dimexp: bets $1.80
gambler4f: calls $1.80
*** SHOW DOWN ***
Dimexp: shows [Qh Js] (a straight, Ten to Ace)
gambler4f: mucks hand
Dimexp collected $7.02 from pot
*** SUMMARY ***
Total pot $7.32 | Rake $0.30
Board [Td Ah Kc 9s 8c]
Seat 1: qk rodriguez (button) folded before Flop (didn't bet)
Seat 2: Baksojor (small blind) folded before Flop
Seat 3: Dimexp (big blind) showed [Qh Js] and won ($7.02) with a straight, Ten to Ace
Seat 4: JFJQ folded before Flop (didn't bet)
Seat 5: Hell Knife folded before Flop (didn't bet)
Seat 6: gambler4f mucked [Ac As]


*********** # 30 **************
PokerStars Zoom Hand #174049332995:  Hold'em No Limit ($0.02/$0.05) - 2017/08/07 23:52:43 MSK [2017/08/07 16:52:43 ET]
Table 'Donati' 6-max Seat #1 is the button
Seat 1: Oscar__62176 ($10.84 in chips)
Seat 2: Feyqdoi ($5.02 in chips)
Seat 3: IVE244 ($5.47 in chips)
Seat 4: Baksojor ($17.37 in chips)
Seat 5: jockl ($15.31 in chips)
Seat 6: ElbowsKnees ($5.07 in chips)
Feyqdoi: posts small blind $0.02
IVE244: posts big blind $0.05
*** HOLE CARDS ***
Dealt to Baksojor [As 3d]
Baksojor: folds
jockl: folds
ElbowsKnees: folds
Oscar__62176: raises $0.05 to $0.10
Feyqdoi: folds
IVE244: folds
Uncalled bet ($0.05) returned to Oscar__62176
Oscar__62176 collected $0.12 from pot
Oscar__62176: doesn't show hand
*** SUMMARY ***
Total pot $0.12 | Rake $0
Seat 1: Oscar__62176 (button) collected ($0.12)
Seat 2: Feyqdoi (small blind) folded before Flop
Seat 3: IVE244 (big blind) folded before Flop
Seat 4: Baksojor folded before Flop (didn't bet)
Seat 5: jockl folded before Flop (didn't bet)
Seat 6: ElbowsKnees folded before Flop (didn't bet)


*********** # 31 **************
PokerStars Zoom Hand #174049329861:  Hold'em No Limit ($0.02/$0.05) - 2017/08/07 23:52:39 MSK [2017/08/07 16:52:39 ET]
Table 'Donati' 6-max Seat #1 is the button
Seat 1: mthies ($5.63 in chips)
Seat 2: vad1963 ($4.73 in chips)
Seat 3: Levmachinexx ($5.25 in chips)
Seat 4: PayForSee ($17 in chips)
Seat 5: Baksojor ($17.37 in chips)
Seat 6: stakoms82 ($8.95 in chips)
vad1963: posts small blind $0.02
Levmachinexx: posts big blind $0.05
*** HOLE CARDS ***
Dealt to Baksojor [Kc 6d]
PayForSee: folds
Baksojor: folds
stakoms82: folds
mthies: raises $0.07 to $0.12
vad1963: folds
Levmachinexx: folds
Uncalled bet ($0.07) returned to mthies
mthies collected $0.12 from pot
mthies: doesn't show hand
*** SUMMARY ***
Total pot $0.12 | Rake $0
Seat 1: mthies (button) collected ($0.12)
Seat 2: vad1963 (small blind) folded before Flop
Seat 3: Levmachinexx (big blind) folded before Flop
Seat 4: PayForSee folded before Flop (didn't bet)
Seat 5: Baksojor folded before Flop (didn't bet)
Seat 6: stakoms82 folded before Flop (didn't bet)


*********** # 32 **************
PokerStars Zoom Hand #174049292636:  Hold'em No Limit ($0.02/$0.05) - 2017/08/07 23:51:51 MSK [2017/08/07 16:51:51 ET]
Table 'Donati' 6-max Seat #1 is the button
Seat 1: Baksojor ($17 in chips)
Seat 2: Valerij V.S. ($2.64 in chips)
Seat 3: PayForSee ($5.34 in chips)
Seat 4: AlberTSifon ($5.54 in chips)
Seat 5: 777serg58 ($7.23 in chips)
Seat 6: ElbowsKnees ($5.78 in chips)
Valerij V.S.: posts small blind $0.02
PayForSee: posts big blind $0.05
*** HOLE CARDS ***
Dealt to Baksojor [As Kc]
AlberTSifon: folds
777serg58: calls $0.05
ElbowsKnees: raises $0.20 to $0.25
Baksojor: raises $0.50 to $0.75
Valerij V.S.: folds
PayForSee: folds
777serg58: folds
ElbowsKnees: folds
Uncalled bet ($0.50) returned to Baksojor
Baksojor collected $0.62 from pot
Baksojor: doesn't show hand
*** SUMMARY ***
Total pot $0.62 | Rake $0
Seat 1: Baksojor (button) collected ($0.62)
Seat 2: Valerij V.S. (small blind) folded before Flop
Seat 3: PayForSee (big blind) folded before Flop
Seat 4: AlberTSifon folded before Flop (didn't bet)
Seat 5: 777serg58 folded before Flop
Seat 6: ElbowsKnees folded before Flop


*********** # 33 **************
PokerStars Zoom Hand #174049282390:  Hold'em No Limit ($0.02/$0.05) - 2017/08/07 23:51:38 MSK [2017/08/07 16:51:38 ET]
Table 'Donati' 6-max Seat #1 is the button
Seat 1: MárioRJ ($5.46 in chips)
Seat 2: Naosky ($5.30 in chips)
Seat 3: sunset1111 ($5.16 in chips)
Seat 4: schredinger ($3.94 in chips)
Seat 5: Baksojor ($16.93 in chips)
Seat 6: Oscar__62176 ($10.84 in chips)
Naosky: posts small blind $0.02
sunset1111: posts big blind $0.05
*** HOLE CARDS ***
Dealt to Baksojor [Th Ah]
schredinger: folds
Baksojor: raises $0.10 to $0.15
Oscar__62176: folds
MárioRJ: folds
Naosky: folds
sunset1111: folds
Uncalled bet ($0.10) returned to Baksojor
Baksojor collected $0.12 from pot
Baksojor: doesn't show hand
*** SUMMARY ***
Total pot $0.12 | Rake $0
Seat 1: MárioRJ (button) folded before Flop (didn't bet)
Seat 2: Naosky (small blind) folded before Flop
Seat 3: sunset1111 (big blind) folded before Flop
Seat 4: schredinger folded before Flop (didn't bet)
Seat 5: Baksojor collected ($0.12)
Seat 6: Oscar__62176 folded before Flop (didn't bet)


*********** # 34 **************
PokerStars Zoom Hand #174049279316:  Hold'em No Limit ($0.02/$0.05) - 2017/08/07 23:51:34 MSK [2017/08/07 16:51:34 ET]
Table 'Donati' 6-max Seat #1 is the button
Seat 1: Misha250595 ($10.28 in chips)
Seat 2: Monsterpot13 ($2.28 in chips)
Seat 3: 1matodor$ ($8.02 in chips)
Seat 4: Demon31222 ($5 in chips)
Seat 5: sunset1111 ($5.16 in chips)
Seat 6: Baksojor ($16.93 in chips)
Monsterpot13: posts small blind $0.02
1matodor$: posts big blind $0.05
*** HOLE CARDS ***
Dealt to Baksojor [3c Qs]
Demon31222: folds
sunset1111: folds
Baksojor: folds
Misha250595: folds
Monsterpot13: folds
Uncalled bet ($0.03) returned to 1matodor$
1matodor$ collected $0.04 from pot
1matodor$: doesn't show hand
*** SUMMARY ***
Total pot $0.04 | Rake $0
Seat 1: Misha250595 (button) folded before Flop (didn't bet)
Seat 2: Monsterpot13 (small blind) folded before Flop
Seat 3: 1matodor$ (big blind) collected ($0.04)
Seat 4: Demon31222 folded before Flop (didn't bet)
Seat 5: sunset1111 folded before Flop (didn't bet)
Seat 6: Baksojor folded before Flop (didn't bet)


*********** # 35 **************
PokerStars Zoom Hand #174049269242:  Hold'em No Limit ($0.02/$0.05) - 2017/08/07 23:51:21 MSK [2017/08/07 16:51:21 ET]
Table 'Donati' 6-max Seat #1 is the button
Seat 1: carpente285 ($2.56 in chips)
Seat 2: nodarik1980 ($5 in chips)
Seat 3: Baksojor ($16.91 in chips)
Seat 4: Avallonis ($5.24 in chips)
Seat 5: filipzic ($8.40 in chips)
Seat 6: MiyagiMaster ($5.02 in chips)
nodarik1980: posts small blind $0.02
Baksojor: posts big blind $0.05
*** HOLE CARDS ***
Dealt to Baksojor [2c Jc]
Avallonis: folds
filipzic: folds
MiyagiMaster: folds
carpente285: folds
nodarik1980: folds
Uncalled bet ($0.03) returned to Baksojor
Baksojor collected $0.04 from pot
Baksojor: doesn't show hand
*** SUMMARY ***
Total pot $0.04 | Rake $0
Seat 1: carpente285 (button) folded before Flop (didn't bet)
Seat 2: nodarik1980 (small blind) folded before Flop
Seat 3: Baksojor (big blind) collected ($0.04)
Seat 4: Avallonis folded before Flop (didn't bet)
Seat 5: filipzic folded before Flop (didn't bet)
Seat 6: MiyagiMaster folded before Flop (didn't bet)


*********** # 36 **************
PokerStars Zoom Hand #174049265130:  Hold'em No Limit ($0.02/$0.05) - 2017/08/07 23:51:16 MSK [2017/08/07 16:51:16 ET]
Table 'Donati' 6-max Seat #1 is the button
Seat 1: StephBpee ($3.90 in chips)
Seat 2: Sviat47 ($4.80 in chips)
Seat 3: NEAVH100 ($4.60 in chips)
Seat 4: hen1337 ($7.77 in chips)
Seat 5: Baksojor ($16.91 in chips)
Seat 6: V.S.151 ($10.54 in chips)
Sviat47: posts small blind $0.02
NEAVH100: posts big blind $0.05
*** HOLE CARDS ***
Dealt to Baksojor [8d Qh]
hen1337: folds
Baksojor: folds
V.S.151: folds
StephBpee: folds
Sviat47: folds
Uncalled bet ($0.03) returned to NEAVH100
NEAVH100 collected $0.04 from pot
NEAVH100: doesn't show hand
*** SUMMARY ***
Total pot $0.04 | Rake $0
Seat 1: StephBpee (button) folded before Flop (didn't bet)
Seat 2: Sviat47 (small blind) folded before Flop
Seat 3: NEAVH100 (big blind) collected ($0.04)
Seat 4: hen1337 folded before Flop (didn't bet)
Seat 5: Baksojor folded before Flop (didn't bet)
Seat 6: V.S.151 folded before Flop (didn't bet)


*********** # 37 **************
PokerStars Zoom Hand #174049225949:  Hold'em No Limit ($0.02/$0.05) - 2017/08/07 23:50:26 MSK [2017/08/07 16:50:26 ET]
Table 'Donati' 6-max Seat #1 is the button
Seat 1: Baksojor ($17.16 in chips)
Seat 2: bigamus ($6.06 in chips)
Seat 3: Lina6591 ($2.73 in chips)
Seat 4: Sobo030 ($6.94 in chips)
Seat 5: Verros1991 ($6.94 in chips)
Seat 6: Linkk1 ($5 in chips)
bigamus: posts small blind $0.02
Lina6591: posts big blind $0.05
*** HOLE CARDS ***
Dealt to Baksojor [9h Ac]
Sobo030: folds
Verros1991: folds
Linkk1: folds
Baksojor: raises $0.05 to $0.10
bigamus: calls $0.08
Lina6591: folds
*** FLOP *** [6d 8s Tc]
bigamus: checks
Baksojor: bets $0.15
bigamus: raises $0.25 to $0.40
Baksojor: folds
Uncalled bet ($0.25) returned to bigamus
bigamus collected $0.53 from pot
bigamus: doesn't show hand
*** SUMMARY ***
Total pot $0.55 | Rake $0.02
Board [6d 8s Tc]
Seat 1: Baksojor (button) folded on the Flop
Seat 2: bigamus (small blind) collected ($0.53)
Seat 3: Lina6591 (big blind) folded before Flop
Seat 4: Sobo030 folded before Flop (didn't bet)
Seat 5: Verros1991 folded before Flop (didn't bet)
Seat 6: Linkk1 folded before Flop (didn't bet)


*********** # 38 **************
PokerStars Zoom Hand #174049180251:  Hold'em No Limit ($0.02/$0.05) - 2017/08/07 23:49:29 MSK [2017/08/07 16:49:29 ET]
Table 'Donati' 6-max Seat #1 is the button
Seat 1: AKKbank ($5.89 in chips)
Seat 2: Baksojor ($16.45 in chips)
Seat 3: alexnn15 ($8.48 in chips)
Seat 4: IldarD86 ($7.77 in chips)
Seat 5: aqvarel80 ($4.99 in chips)
Seat 6: Jack123985 ($5.03 in chips)
Baksojor: posts small blind $0.02
alexnn15: posts big blind $0.05
*** HOLE CARDS ***
Dealt to Baksojor [7h 6h]
IldarD86: folds
aqvarel80: calls $0.05
Jack123985: folds
AKKbank: raises $0.15 to $0.20
Baksojor: calls $0.18
alexnn15: folds
aqvarel80: calls $0.15
*** FLOP *** [7s Td 3h]
Baksojor: checks
aqvarel80: checks
AKKbank: bets $0.31
Baksojor: calls $0.31
aqvarel80: folds
*** TURN *** [7s Td 3h] [9d]
Baksojor: checks
AKKbank: checks
*** RIVER *** [7s Td 3h 9d] [Jc]
Baksojor: checks
AKKbank: checks
*** SHOW DOWN ***
Baksojor: shows [7h 6h] (a pair of Sevens)
AKKbank: mucks hand
Baksojor collected $1.22 from pot
*** SUMMARY ***
Total pot $1.27 | Rake $0.05
Board [7s Td 3h 9d Jc]
Seat 1: AKKbank (button) mucked [Ac Qs]
Seat 2: Baksojor (small blind) showed [7h 6h] and won ($1.22) with a pair of Sevens
Seat 3: alexnn15 (big blind) folded before Flop
Seat 4: IldarD86 folded before Flop (didn't bet)
Seat 5: aqvarel80 folded on the Flop
Seat 6: Jack123985 folded before Flop (didn't bet)


*********** # 39 **************
PokerStars Zoom Hand #174049144874:  Hold'em No Limit ($0.02/$0.05) - 2017/08/07 23:48:48 MSK [2017/08/07 16:48:48 ET]
Table 'Donati' 6-max Seat #1 is the button
Seat 1: fam007007 ($7.79 in chips)
Seat 2: Pechkin85 ($5 in chips)
Seat 3: Yoeram ($5 in chips)
Seat 4: V.S.151 ($4.76 in chips)
Seat 5: Baksojor ($16.60 in chips)
Seat 6: Scar_spb ($9.45 in chips)
Pechkin85: posts small blind $0.02
Yoeram: posts big blind $0.05
*** HOLE CARDS ***
Dealt to Baksojor [4c 4d]
V.S.151: raises $0.10 to $0.15
Baksojor: calls $0.15
Scar_spb: folds
fam007007: calls $0.15
Pechkin85: calls $0.13
Yoeram: folds
*** FLOP *** [8h Jd Jc]
Pechkin85: checks
V.S.151: checks
Baksojor: checks
fam007007: checks
*** TURN *** [8h Jd Jc] [5s]
Pechkin85: bets $0.47
V.S.151: calls $0.47
Baksojor: folds
fam007007: folds
*** RIVER *** [8h Jd Jc 5s] [6s]
Pechkin85: checks
V.S.151: checks
*** SHOW DOWN ***
Pechkin85: shows [9s Ts] (a pair of Jacks)
V.S.151: shows [Qh Qs] (two pair, Queens and Jacks)
V.S.151 collected $1.52 from pot
*** SUMMARY ***
Total pot $1.59 | Rake $0.07
Board [8h Jd Jc 5s 6s]
Seat 1: fam007007 (button) folded on the Turn
Seat 2: Pechkin85 (small blind) showed [9s Ts] and lost with a pair of Jacks
Seat 3: Yoeram (big blind) folded before Flop
Seat 4: V.S.151 showed [Qh Qs] and won ($1.52) with two pair, Queens and Jacks
Seat 5: Baksojor folded on the Turn
Seat 6: Scar_spb folded before Flop (didn't bet)


*********** # 40 **************
PokerStars Zoom Hand #174049042193:  Hold'em No Limit ($0.02/$0.05) - 2017/08/07 23:46:53 MSK [2017/08/07 16:46:53 ET]
Table 'Donati' 6-max Seat #1 is the button
Seat 1: Igor22913 ($6.10 in chips)
Seat 2: ULTRAST87 ($5.31 in chips)
Seat 3: Baksojor ($18.11 in chips)
Seat 4: Huk3k ($6.55 in chips)
Seat 5: Oscar__62176 ($5.16 in chips)
Seat 6: biv12 ($4.13 in chips)
ULTRAST87: posts small blind $0.02
Baksojor: posts big blind $0.05
*** HOLE CARDS ***
Dealt to Baksojor [Kd Kh]
Huk3k: calls $0.05
Oscar__62176: folds
biv12: folds
Igor22913: folds
ULTRAST87: raises $0.15 to $0.20
Baksojor: raises $0.45 to $0.65
Huk3k: folds
ULTRAST87: calls $0.45
*** FLOP *** [5d 9s Qs]
ULTRAST87: checks
Baksojor: bets $0.86
ULTRAST87: calls $0.86
*** TURN *** [5d 9s Qs] [Ac]
ULTRAST87: checks
Baksojor: checks
*** RIVER *** [5d 9s Qs Ac] [Tc]
ULTRAST87: bets $1.68
Baksojor: folds
Uncalled bet ($1.68) returned to ULTRAST87
ULTRAST87 collected $2.94 from pot
ULTRAST87: doesn't show hand
*** SUMMARY ***
Total pot $3.07 | Rake $0.13
Board [5d 9s Qs Ac Tc]
Seat 1: Igor22913 (button) folded before Flop (didn't bet)
Seat 2: ULTRAST87 (small blind) collected ($2.94)
Seat 3: Baksojor (big blind) folded on the River
Seat 4: Huk3k folded before Flop
Seat 5: Oscar__62176 folded before Flop (didn't bet)
Seat 6: biv12 folded before Flop (didn't bet)


*********** # 41 **************
PokerStars Zoom Hand #174049037560:  Hold'em No Limit ($0.02/$0.05) - 2017/08/07 23:46:47 MSK [2017/08/07 16:46:47 ET]
Table 'Donati' 6-max Seat #1 is the button
Seat 1: fam007007 ($4.86 in chips)
Seat 2: sannitar ($5.94 in chips)
Seat 3: joysaa ($4.98 in chips)
Seat 4: ksrepin ($21.68 in chips)
Seat 5: fevpez ($4.55 in chips)
Seat 6: Baksojor ($18.11 in chips)
sannitar: posts small blind $0.02
joysaa: posts big blind $0.05
*** HOLE CARDS ***
Dealt to Baksojor [2d Kc]
ksrepin: folds
fevpez: folds
Baksojor: folds
fam007007: folds
sannitar: folds
Uncalled bet ($0.03) returned to joysaa
joysaa collected $0.04 from pot
joysaa: doesn't show hand
*** SUMMARY ***
Total pot $0.04 | Rake $0
Seat 1: fam007007 (button) folded before Flop (didn't bet)
Seat 2: sannitar (small blind) folded before Flop
Seat 3: joysaa (big blind) collected ($0.04)
Seat 4: ksrepin folded before Flop (didn't bet)
Seat 5: fevpez folded before Flop (didn't bet)
Seat 6: Baksojor folded before Flop (didn't bet)


*********** # 42 **************
PokerStars Zoom Hand #174049031344:  Hold'em No Limit ($0.02/$0.05) - 2017/08/07 23:46:39 MSK [2017/08/07 16:46:39 ET]
Table 'Donati' 6-max Seat #1 is the button
Seat 1: boksiukas ($10.67 in chips)
Seat 2: Baksojor ($18.13 in chips)
Seat 3: InteRus13 ($6.61 in chips)
Seat 4: utegil ($1.14 in chips)
Seat 5: 007x2 ($5.80 in chips)
Seat 6: qk rodriguez ($8.46 in chips)
Baksojor: posts small blind $0.02
InteRus13: posts big blind $0.05
*** HOLE CARDS ***
Dealt to Baksojor [6s Js]
utegil: calls $0.05
007x2: folds
qk rodriguez: folds
boksiukas: folds
Baksojor: folds
InteRus13: checks
*** FLOP *** [Th Kc 9s]
InteRus13: checks
utegil: bets $0.05
InteRus13: folds
Uncalled bet ($0.05) returned to utegil
utegil collected $0.12 from pot
utegil: doesn't show hand
*** SUMMARY ***
Total pot $0.12 | Rake $0
Board [Th Kc 9s]
Seat 1: boksiukas (button) folded before Flop (didn't bet)
Seat 2: Baksojor (small blind) folded before Flop
Seat 3: InteRus13 (big blind) folded on the Flop
Seat 4: utegil collected ($0.12)
Seat 5: 007x2 folded before Flop (didn't bet)
Seat 6: qk rodriguez folded before Flop (didn't bet)


*********** # 43 **************
PokerStars Zoom Hand #174049011177:  Hold'em No Limit ($0.02/$0.05) - 2017/08/07 23:46:13 MSK [2017/08/07 16:46:13 ET]
Table 'Donati' 6-max Seat #1 is the button
Seat 1: Baksojor ($18.02 in chips)
Seat 2: thaddäus29 ($4.64 in chips)
Seat 3: Sathar123 ($5.14 in chips)
Seat 4: kam22.cz ($5.09 in chips)
Seat 5: Mr_Wallker ($2.71 in chips)
Seat 6: e2m8 ($4.84 in chips)
thaddäus29: posts small blind $0.02
Sathar123: posts big blind $0.05
*** HOLE CARDS ***
Dealt to Baksojor [8h Ah]
kam22.cz: folds
Mr_Wallker: folds
e2m8: folds
Baksojor: raises $0.05 to $0.10
thaddäus29: folds
Sathar123: calls $0.05
*** FLOP *** [5d 9h 4h]
Sathar123: checks
Baksojor: bets $0.14
Sathar123: folds
Uncalled bet ($0.14) returned to Baksojor
Baksojor collected $0.21 from pot
Baksojor: doesn't show hand
*** SUMMARY ***
Total pot $0.22 | Rake $0.01
Board [5d 9h 4h]
Seat 1: Baksojor (button) collected ($0.21)
Seat 2: thaddäus29 (small blind) folded before Flop
Seat 3: Sathar123 (big blind) folded on the Flop
Seat 4: kam22.cz folded before Flop (didn't bet)
Seat 5: Mr_Wallker folded before Flop (didn't bet)
Seat 6: e2m8 folded before Flop (didn't bet)


*********** # 44 **************
PokerStars Zoom Hand #174049008065:  Hold'em No Limit ($0.02/$0.05) - 2017/08/07 23:46:09 MSK [2017/08/07 16:46:09 ET]
Table 'Donati' 6-max Seat #1 is the button
Seat 1: smither83 ($3.69 in chips)
Seat 2: Suzibelaa ($5.46 in chips)
Seat 3: AndreyK11 ($5 in chips)
Seat 4: Baksojor ($18.02 in chips)
Seat 5: hen1337 ($8.29 in chips)
Seat 6: Naosky ($8.26 in chips)
Suzibelaa: posts small blind $0.02
AndreyK11: posts big blind $0.05
*** HOLE CARDS ***
Dealt to Baksojor [8h 5h]
Baksojor: folds
hen1337: folds
Naosky: raises $0.10 to $0.15
smither83: folds
Suzibelaa: folds
AndreyK11: raises $0.35 to $0.50
Naosky: folds
Uncalled bet ($0.35) returned to AndreyK11
AndreyK11 collected $0.32 from pot
AndreyK11: doesn't show hand
*** SUMMARY ***
Total pot $0.32 | Rake $0
Seat 1: smither83 (button) folded before Flop (didn't bet)
Seat 2: Suzibelaa (small blind) folded before Flop
Seat 3: AndreyK11 (big blind) collected ($0.32)
Seat 4: Baksojor folded before Flop (didn't bet)
Seat 5: hen1337 folded before Flop (didn't bet)
Seat 6: Naosky folded before Flop


*********** # 45 **************
PokerStars Zoom Hand #174049005017:  Hold'em No Limit ($0.02/$0.05) - 2017/08/07 23:46:05 MSK [2017/08/07 16:46:05 ET]
Table 'Donati' 6-max Seat #1 is the button
Seat 1: Feyqdoi ($9.86 in chips)
Seat 2: SergeySURK ($5.38 in chips)
Seat 3: P.J.Shaytan ($5.23 in chips)
Seat 4: mrGold443 ($5 in chips)
Seat 5: McDabr ($4.24 in chips)
Seat 6: Baksojor ($18.02 in chips)
SergeySURK: posts small blind $0.02
P.J.Shaytan: posts big blind $0.05
*** HOLE CARDS ***
Dealt to Baksojor [5s 6d]
mrGold443: folds
McDabr: folds
Baksojor: folds
Feyqdoi: raises $0.07 to $0.12
SergeySURK: folds
P.J.Shaytan: raises $0.43 to $0.55
Feyqdoi: folds
Uncalled bet ($0.43) returned to P.J.Shaytan
P.J.Shaytan collected $0.26 from pot
P.J.Shaytan: doesn't show hand
*** SUMMARY ***
Total pot $0.26 | Rake $0
Seat 1: Feyqdoi (button) folded before Flop
Seat 2: SergeySURK (small blind) folded before Flop
Seat 3: P.J.Shaytan (big blind) collected ($0.26)
Seat 4: mrGold443 folded before Flop (didn't bet)
Seat 5: McDabr folded before Flop (didn't bet)
Seat 6: Baksojor folded before Flop (didn't bet)


*********** # 46 **************
PokerStars Zoom Hand #174048992507:  Hold'em No Limit ($0.02/$0.05) - 2017/08/07 23:45:49 MSK [2017/08/07 16:45:49 ET]
Table 'Donati' 6-max Seat #1 is the button
Seat 1: Mikaeus ($9.07 in chips)
Seat 2: BrainGuru ($7.10 in chips)
Seat 3: Baksojor ($18.07 in chips)
Seat 4: gesa.lienhop ($5.18 in chips)
Seat 5: TrotiLo ($13.92 in chips)
Seat 6: KCH288 ($5.28 in chips)
BrainGuru: posts small blind $0.02
Baksojor: posts big blind $0.05
*** HOLE CARDS ***
Dealt to Baksojor [5d 3h]
gesa.lienhop: folds
TrotiLo: folds
KCH288: folds
Mikaeus: raises $0.07 to $0.12
BrainGuru: folds
Baksojor: folds
Uncalled bet ($0.07) returned to Mikaeus
Mikaeus collected $0.12 from pot
Mikaeus: doesn't show hand
*** SUMMARY ***
Total pot $0.12 | Rake $0
Seat 1: Mikaeus (button) collected ($0.12)
Seat 2: BrainGuru (small blind) folded before Flop
Seat 3: Baksojor (big blind) folded before Flop
Seat 4: gesa.lienhop folded before Flop (didn't bet)
Seat 5: TrotiLo folded before Flop (didn't bet)
Seat 6: KCH288 folded before Flop (didn't bet)


*********** # 47 **************
PokerStars Zoom Hand #174048989319:  Hold'em No Limit ($0.02/$0.05) - 2017/08/07 23:45:45 MSK [2017/08/07 16:45:45 ET]
Table 'Donati' 6-max Seat #1 is the button
Seat 1: jeliax ($5.23 in chips)
Seat 2: Majkee88 ($5.19 in chips)
Seat 3: Batovs ($6.29 in chips)
Seat 4: Baksojor ($18.07 in chips)
Seat 5: thaddäus29 ($4.69 in chips)
Seat 6: reibejk ($10.78 in chips)
Majkee88: posts small blind $0.02
Batovs: posts big blind $0.05
*** HOLE CARDS ***
Dealt to Baksojor [2s 5c]
Baksojor: folds
thaddäus29: folds
reibejk: folds
jeliax: folds
Majkee88: folds
Uncalled bet ($0.03) returned to Batovs
Batovs collected $0.04 from pot
Batovs: doesn't show hand
*** SUMMARY ***
Total pot $0.04 | Rake $0
Seat 1: jeliax (button) folded before Flop (didn't bet)
Seat 2: Majkee88 (small blind) folded before Flop
Seat 3: Batovs (big blind) collected ($0.04)
Seat 4: Baksojor folded before Flop (didn't bet)
Seat 5: thaddäus29 folded before Flop (didn't bet)
Seat 6: reibejk folded before Flop (didn't bet)


*********** # 48 **************
PokerStars Zoom Hand #174048945016:  Hold'em No Limit ($0.02/$0.05) - 2017/08/07 23:44:48 MSK [2017/08/07 16:44:48 ET]
Table 'Donati' 6-max Seat #1 is the button
Seat 1: Baksojor ($17.26 in chips)
Seat 2: Pechkin85 ($5 in chips)
Seat 3: Myrryyyy ($3.11 in chips)
Seat 4: 007x2 ($5.20 in chips)
Seat 5: biv12 ($4.47 in chips)
Seat 6: HATERS1337 ($5.46 in chips)
Pechkin85: posts small blind $0.02
Myrryyyy: posts big blind $0.05
*** HOLE CARDS ***
Dealt to Baksojor [9h Ts]
007x2: folds
biv12: folds
HATERS1337: folds
Baksojor: raises $0.05 to $0.10
Pechkin85: calls $0.08
Myrryyyy: calls $0.05
*** FLOP *** [9c Td As]
Pechkin85: checks
Myrryyyy: checks
Baksojor: bets $0.21
Pechkin85: raises $0.47 to $0.68
Myrryyyy: folds
Baksojor: calls $0.47
*** TURN *** [9c Td As] [5h]
Pechkin85: checks
Baksojor: bets $1.15
Pechkin85: folds
Uncalled bet ($1.15) returned to Baksojor
Baksojor collected $1.59 from pot
Baksojor: doesn't show hand
*** SUMMARY ***
Total pot $1.66 | Rake $0.07
Board [9c Td As 5h]
Seat 1: Baksojor (button) collected ($1.59)
Seat 2: Pechkin85 (small blind) folded on the Turn
Seat 3: Myrryyyy (big blind) folded on the Flop
Seat 4: 007x2 folded before Flop (didn't bet)
Seat 5: biv12 folded before Flop (didn't bet)
Seat 6: HATERS1337 folded before Flop (didn't bet)


*********** # 49 **************
PokerStars Zoom Hand #174048940302:  Hold'em No Limit ($0.02/$0.05) - 2017/08/07 23:44:42 MSK [2017/08/07 16:44:42 ET]
Table 'Donati' 6-max Seat #1 is the button
Seat 1: grant8064 ($5 in chips)
Seat 2: Baksojor ($17.28 in chips)
Seat 3: goldbunnies ($5.59 in chips)
Seat 4: Osiris7567 ($7.78 in chips)
Seat 5: FINTIFLYSHKI ($4.62 in chips)
Seat 6: chraeder ($3.39 in chips)
Baksojor: posts small blind $0.02
goldbunnies: posts big blind $0.05
*** HOLE CARDS ***
Dealt to Baksojor [2c Ts]
Osiris7567: raises $0.15 to $0.20
FINTIFLYSHKI: folds
chraeder: folds
grant8064: calls $0.20
Baksojor: folds
goldbunnies: folds
*** FLOP *** [7s Kh 9c]
Osiris7567: bets $0.30
grant8064: calls $0.30
*** TURN *** [7s Kh 9c] [Th]
Osiris7567: bets $0.69
grant8064: calls $0.69
*** RIVER *** [7s Kh 9c Th] [Ac]
Osiris7567: checks
grant8064: bets $3.81 and is all-in
Osiris7567: calls $3.81
*** SHOW DOWN ***
grant8064: shows [Td Jc] (a pair of Tens)
Osiris7567: shows [Kc Ah] (two pair, Aces and Kings)
Osiris7567 collected $9.65 from pot
*** SUMMARY ***
Total pot $10.07 | Rake $0.42
Board [7s Kh 9c Th Ac]
Seat 1: grant8064 (button) showed [Td Jc] and lost with a pair of Tens
Seat 2: Baksojor (small blind) folded before Flop
Seat 3: goldbunnies (big blind) folded before Flop
Seat 4: Osiris7567 showed [Kc Ah] and won ($9.65) with two pair, Aces and Kings
Seat 5: FINTIFLYSHKI folded before Flop (didn't bet)
Seat 6: chraeder folded before Flop (didn't bet)


*********** # 50 **************
PokerStars Zoom Hand #174048934992:  Hold'em No Limit ($0.02/$0.05) - 2017/08/07 23:44:35 MSK [2017/08/07 16:44:35 ET]
Table 'Donati' 6-max Seat #1 is the button
Seat 1: biv12 ($4.47 in chips)
Seat 2: Mak.Alse ($5.02 in chips)
Seat 3: AKKbank ($6.60 in chips)
Seat 4: Memusik ($5.42 in chips)
Seat 5: Levmachinexx ($6.94 in chips)
Seat 6: Baksojor ($17.28 in chips)
Mak.Alse: posts small blind $0.02
AKKbank: posts big blind $0.05
*** HOLE CARDS ***
Dealt to Baksojor [Ac 2d]
Memusik: folds
Levmachinexx: raises $0.10 to $0.15
Baksojor: folds
biv12: folds
Mak.Alse: raises $0.35 to $0.50
AKKbank: folds
Levmachinexx: calls $0.35
*** FLOP *** [5d Ts 6h]
Mak.Alse: checks
Levmachinexx: checks
*** TURN *** [5d Ts 6h] [As]
Mak.Alse: checks
Levmachinexx: checks
*** RIVER *** [5d Ts 6h As] [2c]
Mak.Alse: checks
Levmachinexx: checks
*** SHOW DOWN ***
Mak.Alse: shows [Jc Tc] (a pair of Tens)
Levmachinexx: mucks hand
Mak.Alse collected $1.01 from pot
*** SUMMARY ***
Total pot $1.05 | Rake $0.04
Board [5d Ts 6h As 2c]
Seat 1: biv12 (button) folded before Flop (didn't bet)
Seat 2: Mak.Alse (small blind) showed [Jc Tc] and won ($1.01) with a pair of Tens
Seat 3: AKKbank (big blind) folded before Flop
Seat 4: Memusik folded before Flop (didn't bet)
Seat 5: Levmachinexx mucked [9c 9h]
Seat 6: Baksojor folded before Flop (didn't bet)


*********** # 51 **************
PokerStars Zoom Hand #174048931789:  Hold'em No Limit ($0.02/$0.05) - 2017/08/07 23:44:31 MSK [2017/08/07 16:44:31 ET]
Table 'Donati' 6-max Seat #1 is the button
Seat 1: dudernr1 ($5.18 in chips)
Seat 2: plasencia345 ($5.64 in chips)
Seat 3: PayForSee ($8.48 in chips)
Seat 4: Sviat47 ($7.41 in chips)
Seat 5: Baksojor ($17.28 in chips)
Seat 6: biv12 ($4.47 in chips)
plasencia345: posts small blind $0.02
PayForSee: posts big blind $0.05
*** HOLE CARDS ***
Dealt to Baksojor [7c 2h]
Sviat47: folds
Baksojor: folds
biv12: folds
dudernr1: folds
plasencia345: folds
Uncalled bet ($0.03) returned to PayForSee
PayForSee collected $0.04 from pot
PayForSee: doesn't show hand
*** SUMMARY ***
Total pot $0.04 | Rake $0
Seat 1: dudernr1 (button) folded before Flop (didn't bet)
Seat 2: plasencia345 (small blind) folded before Flop
Seat 3: PayForSee (big blind) collected ($0.04)
Seat 4: Sviat47 folded before Flop (didn't bet)
Seat 5: Baksojor folded before Flop (didn't bet)
Seat 6: biv12 folded before Flop (didn't bet)


*********** # 52 **************
PokerStars Zoom Hand #174048926253:  Hold'em No Limit ($0.02/$0.05) - 2017/08/07 23:44:24 MSK [2017/08/07 16:44:24 ET]
Table 'Donati' 6-max Seat #1 is the button
Seat 1: Mastermuzzz ($5 in chips)
Seat 2: bajinege ($8.47 in chips)
Seat 3: Baksojor ($17.33 in chips)
Seat 4: rhysreece ($9.88 in chips)
Seat 5: ptolemaios99 ($16.12 in chips)
Seat 6: Mampflord ($6.24 in chips)
bajinege: posts small blind $0.02
Baksojor: posts big blind $0.05
*** HOLE CARDS ***
Dealt to Baksojor [7h 4d]
rhysreece: folds
ptolemaios99: raises $0.10 to $0.15
Mampflord: folds
Mastermuzzz: folds
bajinege: folds
Baksojor: folds
Uncalled bet ($0.10) returned to ptolemaios99
ptolemaios99 collected $0.12 from pot
ptolemaios99: doesn't show hand
*** SUMMARY ***
Total pot $0.12 | Rake $0
Seat 1: Mastermuzzz (button) folded before Flop (didn't bet)
Seat 2: bajinege (small blind) folded before Flop
Seat 3: Baksojor (big blind) folded before Flop
Seat 4: rhysreece folded before Flop (didn't bet)
Seat 5: ptolemaios99 collected ($0.12)
Seat 6: Mampflord folded before Flop (didn't bet)


*********** # 53 **************
PokerStars Zoom Hand #174048923058:  Hold'em No Limit ($0.02/$0.05) - 2017/08/07 23:44:20 MSK [2017/08/07 16:44:20 ET]
Table 'Donati' 6-max Seat #1 is the button
Seat 1: boksiukas ($5.28 in chips)
Seat 2: zarmik1986 ($4.28 in chips)
Seat 3: Misha250595 ($7.19 in chips)
Seat 4: fryspigs ($14.63 in chips)
Seat 5: Baksojor ($17.33 in chips)
Seat 6: Scar_spb ($5.09 in chips)
zarmik1986: posts small blind $0.02
Misha250595: posts big blind $0.05
*** HOLE CARDS ***
Dealt to Baksojor [3d 9d]
fryspigs: calls $0.05
Baksojor: folds
Scar_spb: folds
boksiukas: folds
zarmik1986: folds
Misha250595: checks
*** FLOP *** [Ad 4s Ks]
Misha250595: checks
fryspigs: bets $0.05
Misha250595: folds
Uncalled bet ($0.05) returned to fryspigs
fryspigs collected $0.12 from pot
fryspigs: doesn't show hand
*** SUMMARY ***
Total pot $0.12 | Rake $0
Board [Ad 4s Ks]
Seat 1: boksiukas (button) folded before Flop (didn't bet)
Seat 2: zarmik1986 (small blind) folded before Flop
Seat 3: Misha250595 (big blind) folded on the Flop
Seat 4: fryspigs collected ($0.12)
Seat 5: Baksojor folded before Flop (didn't bet)
Seat 6: Scar_spb folded before Flop (didn't bet)


*********** # 54 **************
PokerStars Zoom Hand #174048918413:  Hold'em No Limit ($0.02/$0.05) - 2017/08/07 23:44:14 MSK [2017/08/07 16:44:14 ET]
Table 'Donati' 6-max Seat #1 is the button
Seat 1: Sunny-Shanse ($4.86 in chips)
Seat 2: Baksojor ($17.35 in chips)
Seat 3: felipe_anps ($14.28 in chips)
Seat 4: boksiukas ($11.15 in chips)
Seat 5: Droncha ($15.39 in chips)
Seat 6: Teflonmemory ($7.48 in chips)
Baksojor: posts small blind $0.02
felipe_anps: posts big blind $0.05
*** HOLE CARDS ***
Dealt to Baksojor [5s Qc]
boksiukas: folds
Droncha: raises $0.10 to $0.15
Teflonmemory: folds
Sunny-Shanse: folds
Baksojor: folds
felipe_anps: folds
Uncalled bet ($0.10) returned to Droncha
Droncha collected $0.12 from pot
Droncha: doesn't show hand
*** SUMMARY ***
Total pot $0.12 | Rake $0
Seat 1: Sunny-Shanse (button) folded before Flop (didn't bet)
Seat 2: Baksojor (small blind) folded before Flop
Seat 3: felipe_anps (big blind) folded before Flop
Seat 4: boksiukas folded before Flop (didn't bet)
Seat 5: Droncha collected ($0.12)
Seat 6: Teflonmemory folded before Flop (didn't bet)


*********** # 55 **************
PokerStars Zoom Hand #174048915291:  Hold'em No Limit ($0.02/$0.05) - 2017/08/07 23:44:10 MSK [2017/08/07 16:44:10 ET]
Table 'Donati' 6-max Seat #1 is the button
Seat 1: Girigal ($5.10 in chips)
Seat 2: sevenovici ($16.17 in chips)
Seat 3: Majkee88 ($5.17 in chips)
Seat 4: Baksojor ($17.35 in chips)
Seat 5: AndreyK11 ($11.37 in chips)
Seat 6: Sunny-Shanse ($4.86 in chips)
sevenovici: posts small blind $0.02
Majkee88: posts big blind $0.05
*** HOLE CARDS ***
Dealt to Baksojor [8d 4h]
Baksojor: folds
AndreyK11: folds
Sunny-Shanse: folds
Girigal: raises $0.07 to $0.12
sevenovici: folds
Majkee88: folds
Uncalled bet ($0.07) returned to Girigal
Girigal collected $0.12 from pot
Girigal: doesn't show hand
*** SUMMARY ***
Total pot $0.12 | Rake $0
Seat 1: Girigal (button) collected ($0.12)
Seat 2: sevenovici (small blind) folded before Flop
Seat 3: Majkee88 (big blind) folded before Flop
Seat 4: Baksojor folded before Flop (didn't bet)
Seat 5: AndreyK11 folded before Flop (didn't bet)
Seat 6: Sunny-Shanse folded before Flop (didn't bet)


*********** # 56 **************
PokerStars Zoom Hand #174048899670:  Hold'em No Limit ($0.02/$0.05) - 2017/08/07 23:43:50 MSK [2017/08/07 16:43:50 ET]
Table 'Donati' 6-max Seat #1 is the button
Seat 1: Baksojor ($17.35 in chips)
Seat 2: BennyPasta ($4.36 in chips)
Seat 3: dark h0r$e ($5.25 in chips)
Seat 4: win56987 ($7.04 in chips)
Seat 5: My4Street ($6.10 in chips)
Seat 6: 1matodor$ ($6.06 in chips)
BennyPasta: posts small blind $0.02
dark h0r$e: posts big blind $0.05
*** HOLE CARDS ***
Dealt to Baksojor [3h Jh]
win56987: folds
My4Street: folds
1matodor$: raises $0.06 to $0.11
Baksojor: folds
BennyPasta: folds
dark h0r$e: folds
Uncalled bet ($0.06) returned to 1matodor$
1matodor$ collected $0.12 from pot
1matodor$: doesn't show hand
*** SUMMARY ***
Total pot $0.12 | Rake $0
Seat 1: Baksojor (button) folded before Flop (didn't bet)
Seat 2: BennyPasta (small blind) folded before Flop
Seat 3: dark h0r$e (big blind) folded before Flop
Seat 4: win56987 folded before Flop (didn't bet)
Seat 5: My4Street folded before Flop (didn't bet)
Seat 6: 1matodor$ collected ($0.12)


*********** # 57 **************
PokerStars Zoom Hand #174048890978:  Hold'em No Limit ($0.02/$0.05) - 2017/08/07 23:43:39 MSK [2017/08/07 16:43:39 ET]
Table 'Donati' 6-max Seat #1 is the button
Seat 1: bigamus ($6.14 in chips)
Seat 2: lucky_gabbi ($4.60 in chips)
Seat 3: Swing1025 ($7.57 in chips)
Seat 4: chraeder ($2.08 in chips)
Seat 5: goldbunnies ($5.10 in chips)
Seat 6: Baksojor ($17.35 in chips)
lucky_gabbi: posts small blind $0.02
Swing1025: posts big blind $0.05
*** HOLE CARDS ***
Dealt to Baksojor [8c 6s]
chraeder: raises $0.07 to $0.12
goldbunnies: folds
Baksojor: folds
bigamus: folds
lucky_gabbi: folds
Swing1025: folds
Uncalled bet ($0.07) returned to chraeder
chraeder collected $0.12 from pot
chraeder: doesn't show hand
*** SUMMARY ***
Total pot $0.12 | Rake $0
Seat 1: bigamus (button) folded before Flop (didn't bet)
Seat 2: lucky_gabbi (small blind) folded before Flop
Seat 3: Swing1025 (big blind) folded before Flop
Seat 4: chraeder collected ($0.12)
Seat 5: goldbunnies folded before Flop (didn't bet)
Seat 6: Baksojor folded before Flop (didn't bet)


*********** # 58 **************
PokerStars Zoom Hand #174048879804:  Hold'em No Limit ($0.02/$0.05) - 2017/08/07 23:43:25 MSK [2017/08/07 16:43:25 ET]
Table 'Donati' 6-max Seat #1 is the button
Seat 1: StephBpee ($3.08 in chips)
Seat 2: dudernr1 ($5.11 in chips)
Seat 3: Baksojor ($17.33 in chips)
Seat 4: 7shun7 ($2.65 in chips)
Seat 5: KAKIxBARRY ($5.33 in chips)
Seat 6: Myrryyyy ($2.48 in chips)
dudernr1: posts small blind $0.02
Baksojor: posts big blind $0.05
*** HOLE CARDS ***
Dealt to Baksojor [4c As]
7shun7: folds
KAKIxBARRY: folds
Myrryyyy: folds
StephBpee: folds
dudernr1: folds
Uncalled bet ($0.03) returned to Baksojor
Baksojor collected $0.04 from pot
Baksojor: doesn't show hand
*** SUMMARY ***
Total pot $0.04 | Rake $0
Seat 1: StephBpee (button) folded before Flop (didn't bet)
Seat 2: dudernr1 (small blind) folded before Flop
Seat 3: Baksojor (big blind) collected ($0.04)
Seat 4: 7shun7 folded before Flop (didn't bet)
Seat 5: KAKIxBARRY folded before Flop (didn't bet)
Seat 6: Myrryyyy folded before Flop (didn't bet)


*********** # 59 **************
PokerStars Zoom Hand #174048876704:  Hold'em No Limit ($0.02/$0.05) - 2017/08/07 23:43:21 MSK [2017/08/07 16:43:21 ET]
Table 'Donati' 6-max Seat #1 is the button
Seat 1: nitzed12 ($6.10 in chips)
Seat 2: Baksojor ($17.35 in chips)
Seat 3: kingme698 ($1.11 in chips)
Seat 4: IldarD86 ($5 in chips)
Seat 5: fam007007 ($7.35 in chips)
Seat 6: andypr0 ($5.85 in chips)
Baksojor: posts small blind $0.02
kingme698: posts big blind $0.05
*** HOLE CARDS ***
Dealt to Baksojor [4c Td]
IldarD86: raises $0.05 to $0.10
fam007007: raises $0.15 to $0.25
andypr0: folds
nitzed12: folds
Baksojor: folds
kingme698: calls $0.20
IldarD86: calls $0.15
*** FLOP *** [8c 7s Jc]
kingme698: bets $0.86 and is all-in
IldarD86: folds
fam007007: folds
Uncalled bet ($0.86) returned to kingme698
kingme698 collected $0.74 from pot
kingme698: doesn't show hand
*** SUMMARY ***
Total pot $0.77 | Rake $0.03
Board [8c 7s Jc]
Seat 1: nitzed12 (button) folded before Flop (didn't bet)
Seat 2: Baksojor (small blind) folded before Flop
Seat 3: kingme698 (big blind) collected ($0.74)
Seat 4: IldarD86 folded on the Flop
Seat 5: fam007007 folded on the Flop
Seat 6: andypr0 folded before Flop (didn't bet)


*********** # 60 **************
PokerStars Zoom Hand #174048873608:  Hold'em No Limit ($0.02/$0.05) - 2017/08/07 23:43:17 MSK [2017/08/07 16:43:17 ET]
Table 'Donati' 6-max Seat #1 is the button
Seat 1: 7shun7 ($2.65 in chips)
Seat 2: IHateA14 ($14.43 in chips)
Seat 3: fortune377 ($2.97 in chips)
Seat 4: Oberon63 ($11.10 in chips)
Seat 5: Baksojor ($17.35 in chips)
Seat 6: funkelia ($13.70 in chips)
IHateA14: posts small blind $0.02
fortune377: posts big blind $0.05
*** HOLE CARDS ***
Dealt to Baksojor [8h 7s]
Oberon63: folds
Baksojor: folds
funkelia: folds
7shun7: folds
IHateA14: folds
Uncalled bet ($0.03) returned to fortune377
fortune377 collected $0.04 from pot
fortune377: doesn't show hand
*** SUMMARY ***
Total pot $0.04 | Rake $0
Seat 1: 7shun7 (button) folded before Flop (didn't bet)
Seat 2: IHateA14 (small blind) folded before Flop
Seat 3: fortune377 (big blind) collected ($0.04)
Seat 4: Oberon63 folded before Flop (didn't bet)
Seat 5: Baksojor folded before Flop (didn't bet)
Seat 6: funkelia folded before Flop (didn't bet)


*********** # 61 **************
PokerStars Zoom Hand #174048870498:  Hold'em No Limit ($0.02/$0.05) - 2017/08/07 23:43:13 MSK [2017/08/07 16:43:13 ET]
Table 'Donati' 6-max Seat #1 is the button
Seat 1: Faraon1207 ($6.08 in chips)
Seat 2: kot615 ($1.03 in chips)
Seat 3: B0GEYMAN ($7.55 in chips)
Seat 4: Mr_Wallker ($3.23 in chips)
Seat 5: momiasuk ($7.46 in chips)
Seat 6: Baksojor ($17.35 in chips)
kot615: posts small blind $0.02
B0GEYMAN: posts big blind $0.05
*** HOLE CARDS ***
Dealt to Baksojor [3c 6c]
Mr_Wallker: folds
momiasuk: folds
Baksojor: folds
Faraon1207: folds
kot615: folds
Uncalled bet ($0.03) returned to B0GEYMAN
B0GEYMAN collected $0.04 from pot
B0GEYMAN: doesn't show hand
*** SUMMARY ***
Total pot $0.04 | Rake $0
Seat 1: Faraon1207 (button) folded before Flop (didn't bet)
Seat 2: kot615 (small blind) folded before Flop
Seat 3: B0GEYMAN (big blind) collected ($0.04)
Seat 4: Mr_Wallker folded before Flop (didn't bet)
Seat 5: momiasuk folded before Flop (didn't bet)
Seat 6: Baksojor folded before Flop (didn't bet)


*********** # 62 **************
PokerStars Zoom Hand #174048841489:  Hold'em No Limit ($0.02/$0.05) - 2017/08/07 23:42:36 MSK [2017/08/07 16:42:36 ET]
Table 'Donati' 6-max Seat #1 is the button
Seat 1: Baksojor ($17.70 in chips)
Seat 2: asxetidis13 ($3.59 in chips)
Seat 3: boksiukas ($5.55 in chips)
Seat 4: 999Monstr999 ($2.73 in chips)
Seat 5: plasencia345 ($8.38 in chips)
Seat 6: andypr0 ($5.34 in chips)
asxetidis13: posts small blind $0.02
boksiukas: posts big blind $0.05
*** HOLE CARDS ***
Dealt to Baksojor [Ks 9h]
999Monstr999: folds
plasencia345: folds
andypr0: folds
Baksojor: raises $0.05 to $0.10
asxetidis13: raises $0.25 to $0.35
boksiukas: folds
Baksojor: calls $0.25
*** FLOP *** [6s Qd 2c]
asxetidis13: bets $0.49
Baksojor: folds
Uncalled bet ($0.49) returned to asxetidis13
asxetidis13 collected $0.72 from pot
asxetidis13: doesn't show hand
*** SUMMARY ***
Total pot $0.75 | Rake $0.03
Board [6s Qd 2c]
Seat 1: Baksojor (button) folded on the Flop
Seat 2: asxetidis13 (small blind) collected ($0.72)
Seat 3: boksiukas (big blind) folded before Flop
Seat 4: 999Monstr999 folded before Flop (didn't bet)
Seat 5: plasencia345 folded before Flop (didn't bet)
Seat 6: andypr0 folded before Flop (didn't bet)


*********** # 63 **************
PokerStars Zoom Hand #174048826509:  Hold'em No Limit ($0.02/$0.05) - 2017/08/07 23:42:21 MSK [2017/08/07 16:42:21 ET]
Table 'Donati' 6-max Seat #1 is the button
Seat 1: MAPAT17 ($2.17 in chips)
Seat 2: Aleks Ryder ($41.66 in chips)
Seat 3: Iwanb4 ($9.39 in chips)
Seat 4: Baksojor ($17.70 in chips)
Seat 5: eduardogod ($5.12 in chips)
Seat 6: Lina6591 ($7.15 in chips)
Aleks Ryder: posts small blind $0.02
Iwanb4: posts big blind $0.05
*** HOLE CARDS ***
Dealt to Baksojor [3h 5h]
Baksojor: folds
eduardogod: raises $0.10 to $0.15
Lina6591: folds
MAPAT17: calls $0.15
Aleks Ryder: folds
Iwanb4: raises $9.24 to $9.39 and is all-in
eduardogod: folds
MAPAT17: calls $2.02 and is all-in
Uncalled bet ($7.22) returned to Iwanb4
*** FLOP *** [9h 8d 3s]
*** TURN *** [9h 8d 3s] [Ah]
*** RIVER *** [9h 8d 3s Ah] [Ts]
*** SHOW DOWN ***
Iwanb4: shows [9c 9d] (three of a kind, Nines)
MAPAT17: shows [6d 4d] (high card Ace)
Iwanb4 collected $4.32 from pot
*** SUMMARY ***
Total pot $4.51 | Rake $0.19
Board [9h 8d 3s Ah Ts]
Seat 1: MAPAT17 (button) showed [6d 4d] and lost with high card Ace
Seat 2: Aleks Ryder (small blind) folded before Flop
Seat 3: Iwanb4 (big blind) showed [9c 9d] and won ($4.32) with three of a kind, Nines
Seat 4: Baksojor folded before Flop (didn't bet)
Seat 5: eduardogod folded before Flop
Seat 6: Lina6591 folded before Flop (didn't bet)


*********** # 64 **************
PokerStars Zoom Hand #174048822575:  Hold'em No Limit ($0.02/$0.05) - 2017/08/07 23:42:16 MSK [2017/08/07 16:42:16 ET]
Table 'Donati' 6-max Seat #1 is the button
Seat 1: valdemar803 ($5.72 in chips)
Seat 2: Baksojor ($17.72 in chips)
Seat 3: greenweesst ($3.12 in chips)
Seat 4: 81denis81 ($5 in chips)
Seat 5: xizza ($9.75 in chips)
Seat 6: lesslate ($5.82 in chips)
Baksojor: posts small blind $0.02
greenweesst: posts big blind $0.05
*** HOLE CARDS ***
Dealt to Baksojor [8c Qh]
81denis81: folds
xizza: folds
lesslate: raises $0.07 to $0.12
valdemar803: calls $0.12
Baksojor: folds
greenweesst: folds
*** FLOP *** [2d Ks 9d]
lesslate: checks
valdemar803: bets $0.20
lesslate: folds
Uncalled bet ($0.20) returned to valdemar803
valdemar803 collected $0.30 from pot
valdemar803: doesn't show hand
*** SUMMARY ***
Total pot $0.31 | Rake $0.01
Board [2d Ks 9d]
Seat 1: valdemar803 (button) collected ($0.30)
Seat 2: Baksojor (small blind) folded before Flop
Seat 3: greenweesst (big blind) folded before Flop
Seat 4: 81denis81 folded before Flop (didn't bet)
Seat 5: xizza folded before Flop (didn't bet)
Seat 6: lesslate folded on the Flop


*********** # 65 **************
PokerStars Zoom Hand #174048804579:  Hold'em No Limit ($0.02/$0.05) - 2017/08/07 23:41:53 MSK [2017/08/07 16:41:53 ET]
Table 'Donati' 6-max Seat #1 is the button
Seat 1: maltrine ($4.71 in chips)
Seat 2: Naosky ($5.07 in chips)
Seat 3: Baksojor ($17.70 in chips)
Seat 4: aveeear ($5.12 in chips)
Seat 5: nippesboy ($5 in chips)
Seat 6: delgadolisto ($3.40 in chips)
Naosky: posts small blind $0.02
Baksojor: posts big blind $0.05
*** HOLE CARDS ***
Dealt to Baksojor [4s Ts]
aveeear: folds
nippesboy: folds
delgadolisto: folds
maltrine: folds
Naosky: folds
Uncalled bet ($0.03) returned to Baksojor
Baksojor collected $0.04 from pot
Baksojor: doesn't show hand
*** SUMMARY ***
Total pot $0.04 | Rake $0
Seat 1: maltrine (button) folded before Flop (didn't bet)
Seat 2: Naosky (small blind) folded before Flop
Seat 3: Baksojor (big blind) collected ($0.04)
Seat 4: aveeear folded before Flop (didn't bet)
Seat 5: nippesboy folded before Flop (didn't bet)
Seat 6: delgadolisto folded before Flop (didn't bet)


*********** # 66 **************
PokerStars Zoom Hand #174048800758:  Hold'em No Limit ($0.02/$0.05) - 2017/08/07 23:41:48 MSK [2017/08/07 16:41:48 ET]
Table 'Donati' 6-max Seat #1 is the button
Seat 1: 1matodor$ ($6.10 in chips)
Seat 2: sannitar ($5.70 in chips)
Seat 3: guadz ($4.70 in chips)
Seat 4: Baksojor ($17.70 in chips)
Seat 5: IldarD86 ($5 in chips)
Seat 6: ALF48 ($5 in chips)
sannitar: posts small blind $0.02
guadz: posts big blind $0.05
*** HOLE CARDS ***
Dealt to Baksojor [Jd 5s]
Baksojor: folds
IldarD86: folds
ALF48: folds
1matodor$: raises $0.06 to $0.11
sannitar: raises $0.36 to $0.47
guadz: folds
1matodor$: folds
Uncalled bet ($0.36) returned to sannitar
sannitar collected $0.27 from pot
sannitar: doesn't show hand
*** SUMMARY ***
Total pot $0.27 | Rake $0
Seat 1: 1matodor$ (button) folded before Flop
Seat 2: sannitar (small blind) collected ($0.27)
Seat 3: guadz (big blind) folded before Flop
Seat 4: Baksojor folded before Flop (didn't bet)
Seat 5: IldarD86 folded before Flop (didn't bet)
Seat 6: ALF48 folded before Flop (didn't bet)


*********** # 67 **************
PokerStars Zoom Hand #174048797643:  Hold'em No Limit ($0.02/$0.05) - 2017/08/07 23:41:44 MSK [2017/08/07 16:41:44 ET]
Table 'Donati' 6-max Seat #1 is the button
Seat 1: guadz ($4.70 in chips)
Seat 2: ALF48 ($5.02 in chips)
Seat 3: Konkronus ($7.36 in chips)
Seat 4: CaptainPkr X ($7.03 in chips)
Seat 5: Baksojor ($17.70 in chips)
Seat 6: Faraon1207 ($5 in chips)
ALF48: posts small blind $0.02
Konkronus: posts big blind $0.05
*** HOLE CARDS ***
Dealt to Baksojor [5s 3c]
CaptainPkr X: folds
Baksojor: folds
Faraon1207: folds
guadz: folds
ALF48: folds
Uncalled bet ($0.03) returned to Konkronus
Konkronus collected $0.04 from pot
Konkronus: doesn't show hand
*** SUMMARY ***
Total pot $0.04 | Rake $0
Seat 1: guadz (button) folded before Flop (didn't bet)
Seat 2: ALF48 (small blind) folded before Flop
Seat 3: Konkronus (big blind) collected ($0.04)
Seat 4: CaptainPkr X folded before Flop (didn't bet)
Seat 5: Baksojor folded before Flop (didn't bet)
Seat 6: Faraon1207 folded before Flop (didn't bet)


*********** # 68 **************
PokerStars Zoom Hand #174048772402:  Hold'em No Limit ($0.02/$0.05) - 2017/08/07 23:41:12 MSK [2017/08/07 16:41:12 ET]
Table 'Donati' 6-max Seat #1 is the button
Seat 1: Baksojor ($17.63 in chips)
Seat 2: Yahan588 ($8.22 in chips)
Seat 3: Droncha ($4.98 in chips)
Seat 4: win56987 ($6.08 in chips)
Seat 5: Panag88 ($6.13 in chips)
Seat 6: Konkronus ($5.02 in chips)
Yahan588: posts small blind $0.02
Droncha: posts big blind $0.05
*** HOLE CARDS ***
Dealt to Baksojor [3h 6d]
win56987: folds
Panag88: folds
Konkronus: folds
Baksojor: raises $0.05 to $0.10
Yahan588: folds
Droncha: folds
Uncalled bet ($0.05) returned to Baksojor
Baksojor collected $0.12 from pot
Baksojor: doesn't show hand
*** SUMMARY ***
Total pot $0.12 | Rake $0
Seat 1: Baksojor (button) collected ($0.12)
Seat 2: Yahan588 (small blind) folded before Flop
Seat 3: Droncha (big blind) folded before Flop
Seat 4: win56987 folded before Flop (didn't bet)
Seat 5: Panag88 folded before Flop (didn't bet)
Seat 6: Konkronus folded before Flop (didn't bet)


*********** # 69 **************
PokerStars Zoom Hand #174048768462:  Hold'em No Limit ($0.02/$0.05) - 2017/08/07 23:41:07 MSK [2017/08/07 16:41:07 ET]
Table 'Donati' 6-max Seat #1 is the button
Seat 1: Demon31222 ($5.20 in chips)
Seat 2: terribly16 ($8.28 in chips)
Seat 3: kot615 ($1.44 in chips)
Seat 4: funkelia ($10.63 in chips)
Seat 5: ALF48 ($6.26 in chips)
Seat 6: Baksojor ($17.63 in chips)
terribly16: posts small blind $0.02
kot615: posts big blind $0.05
*** HOLE CARDS ***
Dealt to Baksojor [8d Qs]
funkelia: folds
ALF48: folds
Baksojor: folds
Demon31222: folds
terribly16: raises $0.10 to $0.15
kot615: folds
Uncalled bet ($0.10) returned to terribly16
terribly16 collected $0.10 from pot
terribly16: doesn't show hand
*** SUMMARY ***
Total pot $0.10 | Rake $0
Seat 1: Demon31222 (button) folded before Flop (didn't bet)
Seat 2: terribly16 (small blind) collected ($0.10)
Seat 3: kot615 (big blind) folded before Flop
Seat 4: funkelia folded before Flop (didn't bet)
Seat 5: ALF48 folded before Flop (didn't bet)
Seat 6: Baksojor folded before Flop (didn't bet)


*********** # 70 **************
PokerStars Zoom Hand #174048760612:  Hold'em No Limit ($0.02/$0.05) - 2017/08/07 23:40:57 MSK [2017/08/07 16:40:57 ET]
Table 'Donati' 6-max Seat #1 is the button
Seat 1: maltrine ($4.88 in chips)
Seat 2: Baksojor ($17.65 in chips)
Seat 3: Supstar L ($17.91 in chips)
Seat 4: gameflix ($5.52 in chips)
Seat 5: V.S.151 ($6.94 in chips)
Seat 6: UnTedesco ($7.97 in chips)
Baksojor: posts small blind $0.02
Supstar L: posts big blind $0.05
*** HOLE CARDS ***
Dealt to Baksojor [8s Ad]
gameflix: raises $0.10 to $0.15
V.S.151: calls $0.15
UnTedesco: calls $0.15
maltrine: folds
Baksojor: folds
Supstar L: folds
*** FLOP *** [2s 4c 9h]
gameflix: bets $0.30
V.S.151: folds
UnTedesco: folds
Uncalled bet ($0.30) returned to gameflix
gameflix collected $0.50 from pot
gameflix: doesn't show hand
*** SUMMARY ***
Total pot $0.52 | Rake $0.02
Board [2s 4c 9h]
Seat 1: maltrine (button) folded before Flop (didn't bet)
Seat 2: Baksojor (small blind) folded before Flop
Seat 3: Supstar L (big blind) folded before Flop
Seat 4: gameflix collected ($0.50)
Seat 5: V.S.151 folded on the Flop
Seat 6: UnTedesco folded on the Flop


*********** # 71 **************
PokerStars Zoom Hand #174048747912:  Hold'em No Limit ($0.02/$0.05) - 2017/08/07 23:40:41 MSK [2017/08/07 16:40:41 ET]
Table 'Donati' 6-max Seat #1 is the button
Seat 1: Baksojor ($17.58 in chips)
Seat 2: Friadent ($6.05 in chips)
Seat 3: dimon36krut ($5.75 in chips)
Seat 4: Girigal ($5.07 in chips)
Seat 5: AndreyK11 ($8.01 in chips)
Seat 6: CocaDurrrr ($6.73 in chips)
Friadent: posts small blind $0.02
dimon36krut: posts big blind $0.05
*** HOLE CARDS ***
Dealt to Baksojor [5s Qd]
Girigal: folds
AndreyK11: folds
CocaDurrrr: folds
Baksojor: raises $0.05 to $0.10
Friadent: folds
dimon36krut: folds
Uncalled bet ($0.05) returned to Baksojor
Baksojor collected $0.12 from pot
Baksojor: doesn't show hand
*** SUMMARY ***
Total pot $0.12 | Rake $0
Seat 1: Baksojor (button) collected ($0.12)
Seat 2: Friadent (small blind) folded before Flop
Seat 3: dimon36krut (big blind) folded before Flop
Seat 4: Girigal folded before Flop (didn't bet)
Seat 5: AndreyK11 folded before Flop (didn't bet)
Seat 6: CocaDurrrr folded before Flop (didn't bet)


*********** # 72 **************
PokerStars Zoom Hand #174048736116:  Hold'em No Limit ($0.02/$0.05) - 2017/08/07 23:40:26 MSK [2017/08/07 16:40:26 ET]
Table 'Donati' 6-max Seat #1 is the button
Seat 1: Toffsla ($7.36 in chips)
Seat 2: Fuerste2508 ($9.12 in chips)
Seat 3: Baksojor ($17.63 in chips)
Seat 4: ULTRAST87 ($3.09 in chips)
Seat 5: BrainGuru ($4.37 in chips)
Seat 6: felipe_anps ($5.14 in chips)
Fuerste2508: posts small blind $0.02
Baksojor: posts big blind $0.05
*** HOLE CARDS ***
Dealt to Baksojor [Th 6c]
ULTRAST87: folds
BrainGuru: folds
felipe_anps: folds
Toffsla: raises $0.07 to $0.12
Fuerste2508: folds
Baksojor: folds
Uncalled bet ($0.07) returned to Toffsla
Toffsla collected $0.12 from pot
Toffsla: doesn't show hand
*** SUMMARY ***
Total pot $0.12 | Rake $0
Seat 1: Toffsla (button) collected ($0.12)
Seat 2: Fuerste2508 (small blind) folded before Flop
Seat 3: Baksojor (big blind) folded before Flop
Seat 4: ULTRAST87 folded before Flop (didn't bet)
Seat 5: BrainGuru folded before Flop (didn't bet)
Seat 6: felipe_anps folded before Flop (didn't bet)


*********** # 73 **************
PokerStars Zoom Hand #174048733030:  Hold'em No Limit ($0.02/$0.05) - 2017/08/07 23:40:22 MSK [2017/08/07 16:40:22 ET]
Table 'Donati' 6-max Seat #1 is the button
Seat 1: pigwas1000 ($5.03 in chips)
Seat 2: respectos87 ($4.63 in chips)
Seat 3: Konkronus ($7.63 in chips)
Seat 4: $nowman1991 ($5.74 in chips)
Seat 5: Oscar__62176 ($5.25 in chips)
Seat 6: Baksojor ($17.63 in chips)
respectos87: posts small blind $0.02
Konkronus: posts big blind $0.05
*** HOLE CARDS ***
Dealt to Baksojor [5s 8s]
$nowman1991: folds
Oscar__62176: folds
Baksojor: folds
pigwas1000: folds
respectos87: folds
Uncalled bet ($0.03) returned to Konkronus
Konkronus collected $0.04 from pot
Konkronus: doesn't show hand
*** SUMMARY ***
Total pot $0.04 | Rake $0
Seat 1: pigwas1000 (button) folded before Flop (didn't bet)
Seat 2: respectos87 (small blind) folded before Flop
Seat 3: Konkronus (big blind) collected ($0.04)
Seat 4: $nowman1991 folded before Flop (didn't bet)
Seat 5: Oscar__62176 folded before Flop (didn't bet)
Seat 6: Baksojor folded before Flop (didn't bet)


*********** # 74 **************
PokerStars Zoom Hand #174048729101:  Hold'em No Limit ($0.02/$0.05) - 2017/08/07 23:40:17 MSK [2017/08/07 16:40:17 ET]
Table 'Donati' 6-max Seat #1 is the button
Seat 1: onootooole ($5.26 in chips)
Seat 2: chilloutrich ($5.30 in chips)
Seat 3: Oberon63 ($5.62 in chips)
Seat 4: Renner32 ($11.05 in chips)
Seat 5: Baksojor ($17.63 in chips)
Seat 6: zen approach ($5.65 in chips)
chilloutrich: posts small blind $0.02
Oberon63: posts big blind $0.05
*** HOLE CARDS ***
Dealt to Baksojor [Jh 2s]
Renner32: folds
Baksojor: folds
zen approach: folds
onootooole: raises $0.05 to $0.10
chilloutrich: folds
Oberon63: folds
Uncalled bet ($0.05) returned to onootooole
onootooole collected $0.12 from pot
onootooole: doesn't show hand
*** SUMMARY ***
Total pot $0.12 | Rake $0
Seat 1: onootooole (button) collected ($0.12)
Seat 2: chilloutrich (small blind) folded before Flop
Seat 3: Oberon63 (big blind) folded before Flop
Seat 4: Renner32 folded before Flop (didn't bet)
Seat 5: Baksojor folded before Flop (didn't bet)
Seat 6: zen approach folded before Flop (didn't bet)


*********** # 75 **************
PokerStars Zoom Hand #174048725954:  Hold'em No Limit ($0.02/$0.05) - 2017/08/07 23:40:13 MSK [2017/08/07 16:40:13 ET]
Table 'Donati' 6-max Seat #1 is the button
Seat 1: fryspigs ($6.03 in chips)
Seat 2: AKKbank ($5.63 in chips)
Seat 3: gesa.lienhop ($5 in chips)
Seat 4: Baksojor ($17.63 in chips)
Seat 5: R1verM0NSTER ($5.19 in chips)
Seat 6: omgitsslave ($5.08 in chips)
AKKbank: posts small blind $0.02
gesa.lienhop: posts big blind $0.05
*** HOLE CARDS ***
Dealt to Baksojor [Jd 5d]
Baksojor: folds
R1verM0NSTER: folds
omgitsslave: folds
fryspigs: calls $0.05
AKKbank: folds
gesa.lienhop: raises $0.15 to $0.20
fryspigs: calls $0.15
*** FLOP *** [6h 7c Kc]
gesa.lienhop: bets $0.20
fryspigs: raises $0.20 to $0.40
gesa.lienhop: calls $0.20
*** TURN *** [6h 7c Kc] [9h]
gesa.lienhop: checks
fryspigs: bets $1.17
gesa.lienhop: calls $1.17
*** RIVER *** [6h 7c Kc 9h] [9c]
gesa.lienhop: checks
fryspigs: bets $3.41
gesa.lienhop: calls $3.23 and is all-in
Uncalled bet ($0.18) returned to fryspigs
*** SHOW DOWN ***
fryspigs: shows [Kh 9d] (a full house, Nines full of Kings)
gesa.lienhop: shows [Qc Ac] (a flush, Ace high)
fryspigs collected $9.60 from pot
*** SUMMARY ***
Total pot $10.02 | Rake $0.42
Board [6h 7c Kc 9h 9c]
Seat 1: fryspigs (button) showed [Kh 9d] and won ($9.60) with a full house, Nines full of Kings
Seat 2: AKKbank (small blind) folded before Flop
Seat 3: gesa.lienhop (big blind) showed [Qc Ac] and lost with a flush, Ace high
Seat 4: Baksojor folded before Flop (didn't bet)
Seat 5: R1verM0NSTER folded before Flop (didn't bet)
Seat 6: omgitsslave folded before Flop (didn't bet)


*********** # 76 **************
PokerStars Zoom Hand #174048708877:  Hold'em No Limit ($0.02/$0.05) - 2017/08/07 23:39:51 MSK [2017/08/07 16:39:51 ET]
Table 'Donati' 6-max Seat #1 is the button
Seat 1: qk rodriguez ($5.04 in chips)
Seat 2: Baksojor ($17.58 in chips)
Seat 3: InteRus13 ($7.02 in chips)
Seat 4: Dava 0060 ($5 in chips)
Seat 5: dontpanique ($22.71 in chips)
Seat 6: FAHHH168 ($5 in chips)
Baksojor: posts small blind $0.02
InteRus13: posts big blind $0.05
*** HOLE CARDS ***
Dealt to Baksojor [Kd Jd]
Dava 0060: folds
dontpanique: folds
FAHHH168: folds
qk rodriguez: folds
Baksojor: raises $0.10 to $0.15
InteRus13: folds
Uncalled bet ($0.10) returned to Baksojor
Baksojor collected $0.10 from pot
Baksojor: doesn't show hand
*** SUMMARY ***
Total pot $0.10 | Rake $0
Seat 1: qk rodriguez (button) folded before Flop (didn't bet)
Seat 2: Baksojor (small blind) collected ($0.10)
Seat 3: InteRus13 (big blind) folded before Flop
Seat 4: Dava 0060 folded before Flop (didn't bet)
Seat 5: dontpanique folded before Flop (didn't bet)
Seat 6: FAHHH168 folded before Flop (didn't bet)


*********** # 77 **************
PokerStars Zoom Hand #174048704137:  Hold'em No Limit ($0.02/$0.05) - 2017/08/07 23:39:45 MSK [2017/08/07 16:39:45 ET]
Table 'Donati' 6-max Seat #1 is the button
Seat 1: Misha250595 ($11.27 in chips)
Seat 2: andypr0 ($15.36 in chips)
Seat 3: Baksojor ($17.63 in chips)
Seat 4: andrey4ik8 ($7.45 in chips)
Seat 5: Myrryyyy ($2.58 in chips)
Seat 6: x12x13 ($39.91 in chips)
andypr0: posts small blind $0.02
Baksojor: posts big blind $0.05
*** HOLE CARDS ***
Dealt to Baksojor [3s Qc]
andrey4ik8: raises $0.05 to $0.10
Myrryyyy: calls $0.10
x12x13: folds
Misha250595: folds
andypr0: folds
Baksojor: folds
*** FLOP *** [4d Qs Td]
andrey4ik8: checks
Myrryyyy: bets $0.15
andrey4ik8: folds
Uncalled bet ($0.15) returned to Myrryyyy
Myrryyyy collected $0.26 from pot
Myrryyyy: doesn't show hand
*** SUMMARY ***
Total pot $0.27 | Rake $0.01
Board [4d Qs Td]
Seat 1: Misha250595 (button) folded before Flop (didn't bet)
Seat 2: andypr0 (small blind) folded before Flop
Seat 3: Baksojor (big blind) folded before Flop
Seat 4: andrey4ik8 folded on the Flop
Seat 5: Myrryyyy collected ($0.26)
Seat 6: x12x13 folded before Flop (didn't bet)


*********** # 78 **************
PokerStars Zoom Hand #174048693212:  Hold'em No Limit ($0.02/$0.05) - 2017/08/07 23:39:31 MSK [2017/08/07 16:39:31 ET]
Table 'Donati' 6-max Seat #1 is the button
Seat 1: Baksojor ($17.56 in chips)
Seat 2: KCH288 ($6.98 in chips)
Seat 3: ferreous26 ($3.57 in chips)
Seat 4: Levmachinexx ($10.90 in chips)
Seat 5: MSKLucky007 ($5.15 in chips)
Seat 6: BunicuStie ($5.04 in chips)
KCH288: posts small blind $0.02
ferreous26: posts big blind $0.05
*** HOLE CARDS ***
Dealt to Baksojor [7c 5s]
Levmachinexx: folds
MSKLucky007: folds
BunicuStie: folds
Baksojor: raises $0.05 to $0.10
KCH288: folds
ferreous26: folds
Uncalled bet ($0.05) returned to Baksojor
Baksojor collected $0.12 from pot
Baksojor: doesn't show hand
*** SUMMARY ***
Total pot $0.12 | Rake $0
Seat 1: Baksojor (button) collected ($0.12)
Seat 2: KCH288 (small blind) folded before Flop
Seat 3: ferreous26 (big blind) folded before Flop
Seat 4: Levmachinexx folded before Flop (didn't bet)
Seat 5: MSKLucky007 folded before Flop (didn't bet)
Seat 6: BunicuStie folded before Flop (didn't bet)


*********** # 79 **************
PokerStars Zoom Hand #174048689293:  Hold'em No Limit ($0.02/$0.05) - 2017/08/07 23:39:26 MSK [2017/08/07 16:39:26 ET]
Table 'Donati' 6-max Seat #1 is the button
Seat 1: Dasha_1989 ($5.75 in chips)
Seat 2: BunicuStie ($5.09 in chips)
Seat 3: ksrepin ($2.75 in chips)
Seat 4: Baksojor ($17.56 in chips)
Seat 5: mthies ($5 in chips)
Seat 6: Pahuljica37 ($4.93 in chips)
BunicuStie: posts small blind $0.02
ksrepin: posts big blind $0.05
*** HOLE CARDS ***
Dealt to Baksojor [9c Js]
Baksojor: folds
mthies: raises $0.07 to $0.12
Pahuljica37: folds
Dasha_1989: folds
BunicuStie: folds
ksrepin: folds
Uncalled bet ($0.07) returned to mthies
mthies collected $0.12 from pot
mthies: doesn't show hand
*** SUMMARY ***
Total pot $0.12 | Rake $0
Seat 1: Dasha_1989 (button) folded before Flop (didn't bet)
Seat 2: BunicuStie (small blind) folded before Flop
Seat 3: ksrepin (big blind) folded before Flop
Seat 4: Baksojor folded before Flop (didn't bet)
Seat 5: mthies collected ($0.12)
Seat 6: Pahuljica37 folded before Flop (didn't bet)


*********** # 80 **************
PokerStars Zoom Hand #174048634223:  Hold'em No Limit ($0.02/$0.05) - 2017/08/07 23:38:16 MSK [2017/08/07 16:38:16 ET]
Table 'Donati' 6-max Seat #1 is the button
Seat 1: shantaf91 ($8.13 in chips)
Seat 2: Bisi6611 ($8.15 in chips)
Seat 3: Dasha_1989 ($6.14 in chips)
Seat 4: AlexxPoltava ($9.12 in chips)
Seat 5: Aleks Ryder ($40.85 in chips)
Seat 6: Baksojor ($16.42 in chips)
Bisi6611: posts small blind $0.02
Dasha_1989: posts big blind $0.05
*** HOLE CARDS ***
Dealt to Baksojor [6s 7s]
AlexxPoltava: folds
Aleks Ryder: folds
Baksojor: raises $0.07 to $0.12
shantaf91: folds
Bisi6611: raises $0.12 to $0.24
Dasha_1989: calls $0.19
Baksojor: calls $0.12
*** FLOP *** [4s Ks 9s]
Bisi6611: bets $0.15
Dasha_1989: calls $0.15
Baksojor: raises $0.45 to $0.60
Bisi6611: calls $0.45
Dasha_1989: folds
*** TURN *** [4s Ks 9s] [9c]
Bisi6611: checks
Baksojor: bets $1.37
Bisi6611: folds
Uncalled bet ($1.37) returned to Baksojor
Baksojor collected $1.98 from pot
Baksojor: doesn't show hand
*** SUMMARY ***
Total pot $2.07 | Rake $0.09
Board [4s Ks 9s 9c]
Seat 1: shantaf91 (button) folded before Flop (didn't bet)
Seat 2: Bisi6611 (small blind) folded on the Turn
Seat 3: Dasha_1989 (big blind) folded on the Flop
Seat 4: AlexxPoltava folded before Flop (didn't bet)
Seat 5: Aleks Ryder folded before Flop (didn't bet)
Seat 6: Baksojor collected ($1.98)


*********** # 81 **************
PokerStars Zoom Hand #174048621553:  Hold'em No Limit ($0.02/$0.05) - 2017/08/07 23:38:00 MSK [2017/08/07 16:38:00 ET]
Table 'Donati' 6-max Seat #1 is the button
Seat 1: Andr1972 ($6.58 in chips)
Seat 2: 1matodor$ ($6.23 in chips)
Seat 3: Baksojor ($16.47 in chips)
Seat 4: HATERS1337 ($5.11 in chips)
Seat 5: GiorgosZ.90 ($4.04 in chips)
Seat 6: Supstar L ($7.57 in chips)
1matodor$: posts small blind $0.02
Baksojor: posts big blind $0.05
*** HOLE CARDS ***
Dealt to Baksojor [6d Js]
HATERS1337: folds
GiorgosZ.90: folds
Supstar L: folds
Andr1972: raises $0.07 to $0.12
1matodor$: folds
Baksojor: folds
Uncalled bet ($0.07) returned to Andr1972
Andr1972 collected $0.12 from pot
Andr1972: doesn't show hand
*** SUMMARY ***
Total pot $0.12 | Rake $0
Seat 1: Andr1972 (button) collected ($0.12)
Seat 2: 1matodor$ (small blind) folded before Flop
Seat 3: Baksojor (big blind) folded before Flop
Seat 4: HATERS1337 folded before Flop (didn't bet)
Seat 5: GiorgosZ.90 folded before Flop (didn't bet)
Seat 6: Supstar L folded before Flop (didn't bet)


*********** # 82 **************
PokerStars Zoom Hand #174048617495:  Hold'em No Limit ($0.02/$0.05) - 2017/08/07 23:37:55 MSK [2017/08/07 16:37:55 ET]
Table 'Donati' 6-max Seat #1 is the button
Seat 1: TristrMistr ($32.56 in chips)
Seat 2: valdemar803 ($5.65 in chips)
Seat 3: ssserg99 ($5 in chips)
Seat 4: gameflix ($5.92 in chips)
Seat 5: Baksojor ($16.47 in chips)
Seat 6: mrmuggins-uk ($3.61 in chips)
valdemar803: posts small blind $0.02
ssserg99: posts big blind $0.05
*** HOLE CARDS ***
Dealt to Baksojor [3s 9s]
gameflix: folds
Baksojor: folds
mrmuggins-uk: folds
TristrMistr: folds
valdemar803: folds
Uncalled bet ($0.03) returned to ssserg99
ssserg99 collected $0.04 from pot
ssserg99: doesn't show hand
*** SUMMARY ***
Total pot $0.04 | Rake $0
Seat 1: TristrMistr (button) folded before Flop (didn't bet)
Seat 2: valdemar803 (small blind) folded before Flop
Seat 3: ssserg99 (big blind) collected ($0.04)
Seat 4: gameflix folded before Flop (didn't bet)
Seat 5: Baksojor folded before Flop (didn't bet)
Seat 6: mrmuggins-uk folded before Flop (didn't bet)


*********** # 83 **************
PokerStars Zoom Hand #174048611949:  Hold'em No Limit ($0.02/$0.05) - 2017/08/07 23:37:48 MSK [2017/08/07 16:37:48 ET]
Table 'Donati' 6-max Seat #1 is the button
Seat 1: nitzed12 ($5.73 in chips)
Seat 2: Baksojor ($16.49 in chips)
Seat 3: b0pp3 ($9.75 in chips)
Seat 4: Mampflord ($5.94 in chips)
Seat 5: B0GEYMAN ($5.05 in chips)
Seat 6: FAHHH168 ($5 in chips)
Baksojor: posts small blind $0.02
b0pp3: posts big blind $0.05
*** HOLE CARDS ***
Dealt to Baksojor [9h 7d]
Mampflord: folds
B0GEYMAN: folds
FAHHH168: folds
nitzed12: folds
Baksojor: folds
Uncalled bet ($0.03) returned to b0pp3
b0pp3 collected $0.04 from pot
b0pp3: doesn't show hand
*** SUMMARY ***
Total pot $0.04 | Rake $0
Seat 1: nitzed12 (button) folded before Flop (didn't bet)
Seat 2: Baksojor (small blind) folded before Flop
Seat 3: b0pp3 (big blind) collected ($0.04)
Seat 4: Mampflord folded before Flop (didn't bet)
Seat 5: B0GEYMAN folded before Flop (didn't bet)
Seat 6: FAHHH168 folded before Flop (didn't bet)


*********** # 84 **************
PokerStars Zoom Hand #174048566515:  Hold'em No Limit ($0.02/$0.05) - 2017/08/07 23:36:50 MSK [2017/08/07 16:36:50 ET]
Table 'Donati' 6-max Seat #1 is the button
Seat 1: Baksojor ($15.56 in chips)
Seat 2: B0GEYMAN ($9.93 in chips)
Seat 3: Mak.Alse ($5 in chips)
Seat 4: williamnik ($9.24 in chips)
Seat 5: ffereff ($5 in chips)
Seat 6: 81denis81 ($7.76 in chips)
B0GEYMAN: posts small blind $0.02
Mak.Alse: posts big blind $0.05
*** HOLE CARDS ***
Dealt to Baksojor [5d Kh]
williamnik: folds
ffereff: folds
81denis81: folds
Baksojor: raises $0.05 to $0.10
B0GEYMAN: folds
Mak.Alse: calls $0.05
*** FLOP *** [Qc 3h 5s]
Mak.Alse: checks
Baksojor: bets $0.12
Mak.Alse: raises $0.23 to $0.35
Baksojor: calls $0.23
*** TURN *** [Qc 3h 5s] [9s]
Mak.Alse: bets $0.54
Baksojor: calls $0.54
*** RIVER *** [Qc 3h 5s 9s] [6h]
Mak.Alse: checks
Baksojor: checks
*** SHOW DOWN ***
Mak.Alse: shows [2c Ac] (high card Ace)
Baksojor: shows [5d Kh] (a pair of Fives)
Baksojor collected $1.92 from pot
*** SUMMARY ***
Total pot $2 | Rake $0.08
Board [Qc 3h 5s 9s 6h]
Seat 1: Baksojor (button) showed [5d Kh] and won ($1.92) with a pair of Fives
Seat 2: B0GEYMAN (small blind) folded before Flop
Seat 3: Mak.Alse (big blind) showed [2c Ac] and lost with high card Ace
Seat 4: williamnik folded before Flop (didn't bet)
Seat 5: ffereff folded before Flop (didn't bet)
Seat 6: 81denis81 folded before Flop (didn't bet)


*********** # 85 **************
PokerStars Zoom Hand #174048563275:  Hold'em No Limit ($0.02/$0.05) - 2017/08/07 23:36:46 MSK [2017/08/07 16:36:46 ET]
Table 'Donati' 6-max Seat #1 is the button
Seat 1: John Pascow ($5.37 in chips)
Seat 2: shantaf91 ($8.20 in chips)
Seat 3: alexandr1280 ($4.27 in chips)
Seat 4: plasencia345 ($5.92 in chips)
Seat 5: Batovs ($5 in chips)
Seat 6: Baksojor ($15.56 in chips)
shantaf91: posts small blind $0.02
alexandr1280: posts big blind $0.05
*** HOLE CARDS ***
Dealt to Baksojor [2d 7s]
plasencia345: folds
Batovs: raises $0.10 to $0.15
Baksojor: folds
John Pascow: folds
shantaf91: folds
alexandr1280: calls $0.10
*** FLOP *** [Jc Qh 4c]
alexandr1280: bets $0.05
Batovs: calls $0.05
*** TURN *** [Jc Qh 4c] [8h]
alexandr1280: bets $0.10
Batovs: raises $0.30 to $0.40
alexandr1280: calls $0.30
*** RIVER *** [Jc Qh 4c 8h] [Tc]
alexandr1280: checks
Batovs: bets $0.39
alexandr1280: calls $0.39
*** SHOW DOWN ***
Batovs: shows [Td 9d] (a straight, Eight to Queen)
alexandr1280: mucks hand
Batovs collected $1.92 from pot
*** SUMMARY ***
Total pot $2 | Rake $0.08
Board [Jc Qh 4c 8h Tc]
Seat 1: John Pascow (button) folded before Flop (didn't bet)
Seat 2: shantaf91 (small blind) folded before Flop
Seat 3: alexandr1280 (big blind) mucked [Ad Js]
Seat 4: plasencia345 folded before Flop (didn't bet)
Seat 5: Batovs showed [Td 9d] and won ($1.92) with a straight, Eight to Queen
Seat 6: Baksojor folded before Flop (didn't bet)


*********** # 86 **************
PokerStars Zoom Hand #174048560102:  Hold'em No Limit ($0.02/$0.05) - 2017/08/07 23:36:42 MSK [2017/08/07 16:36:42 ET]
Table 'Donati' 6-max Seat #1 is the button
Seat 1: $nowman1991 ($5.21 in chips)
Seat 2: valdemar803 ($5.56 in chips)
Seat 3: Warible ($10.82 in chips)
Seat 4: donn1987 ($5.70 in chips)
Seat 5: Baksojor ($15.56 in chips)
Seat 6: Memusik ($4.05 in chips)
valdemar803: posts small blind $0.02
Warible: posts big blind $0.05
*** HOLE CARDS ***
Dealt to Baksojor [Tc 7h]
donn1987: raises $0.10 to $0.15
Baksojor: folds
Memusik: folds
$nowman1991: folds
valdemar803: folds
Warible: folds
Uncalled bet ($0.10) returned to donn1987
donn1987 collected $0.12 from pot
donn1987: doesn't show hand
*** SUMMARY ***
Total pot $0.12 | Rake $0
Seat 1: $nowman1991 (button) folded before Flop (didn't bet)
Seat 2: valdemar803 (small blind) folded before Flop
Seat 3: Warible (big blind) folded before Flop
Seat 4: donn1987 collected ($0.12)
Seat 5: Baksojor folded before Flop (didn't bet)
Seat 6: Memusik folded before Flop (didn't bet)


*********** # 87 **************
PokerStars Zoom Hand #174048540335:  Hold'em No Limit ($0.02/$0.05) - 2017/08/07 23:36:17 MSK [2017/08/07 16:36:17 ET]
Table 'Donati' 6-max Seat #1 is the button
Seat 1: Baksojor ($15.49 in chips)
Seat 2: Mikaeus ($5.09 in chips)
Seat 3: AndreyK11 ($11.71 in chips)
Seat 4: Gogenus ($4.82 in chips)
Seat 5: FuShen66 ($11.09 in chips)
Seat 6: Mampflord ($4.92 in chips)
Mikaeus: posts small blind $0.02
AndreyK11: posts big blind $0.05
*** HOLE CARDS ***
Dealt to Baksojor [2h Th]
Gogenus: folds
FuShen66: folds
Mampflord: folds
Baksojor: raises $0.05 to $0.10
Mikaeus: folds
AndreyK11: folds
Uncalled bet ($0.05) returned to Baksojor
Baksojor collected $0.12 from pot
Baksojor: doesn't show hand
*** SUMMARY ***
Total pot $0.12 | Rake $0
Seat 1: Baksojor (button) collected ($0.12)
Seat 2: Mikaeus (small blind) folded before Flop
Seat 3: AndreyK11 (big blind) folded before Flop
Seat 4: Gogenus folded before Flop (didn't bet)
Seat 5: FuShen66 folded before Flop (didn't bet)
Seat 6: Mampflord folded before Flop (didn't bet)


*********** # 88 **************
PokerStars Zoom Hand #174048537128:  Hold'em No Limit ($0.02/$0.05) - 2017/08/07 23:36:13 MSK [2017/08/07 16:36:13 ET]
Table 'Donati' 6-max Seat #1 is the button
Seat 1: lucky_gabbi ($5.19 in chips)
Seat 2: Baksojor ($15.51 in chips)
Seat 3: 101FILO ($9.09 in chips)
Seat 4: Flash91ua ($6.74 in chips)
Seat 5: maxtel5 ($3.11 in chips)
Seat 6: b72rus ($8.14 in chips)
Baksojor: posts small blind $0.02
101FILO: posts big blind $0.05
*** HOLE CARDS ***
Dealt to Baksojor [6s 4c]
Flash91ua: folds
maxtel5: folds
b72rus: raises $0.09 to $0.14
lucky_gabbi: folds
Baksojor: folds
101FILO: calls $0.09
*** FLOP *** [5d 4d Js]
101FILO: checks
b72rus: bets $0.16
101FILO: calls $0.16
*** TURN *** [5d 4d Js] [8s]
101FILO: checks
b72rus: bets $0.39
101FILO: folds
Uncalled bet ($0.39) returned to b72rus
b72rus collected $0.59 from pot
b72rus: doesn't show hand
*** SUMMARY ***
Total pot $0.62 | Rake $0.03
Board [5d 4d Js 8s]
Seat 1: lucky_gabbi (button) folded before Flop (didn't bet)
Seat 2: Baksojor (small blind) folded before Flop
Seat 3: 101FILO (big blind) folded on the Turn
Seat 4: Flash91ua folded before Flop (didn't bet)
Seat 5: maxtel5 folded before Flop (didn't bet)
Seat 6: b72rus collected ($0.59)


*********** # 89 **************
PokerStars Zoom Hand #174048527642:  Hold'em No Limit ($0.02/$0.05) - 2017/08/07 23:36:01 MSK [2017/08/07 16:36:01 ET]
Table 'Donati' 6-max Seat #1 is the button
Seat 1: Sobo030 ($5 in chips)
Seat 2: cooller.GG ($4.89 in chips)
Seat 3: Baksojor ($15.49 in chips)
Seat 4: cryptozee ($1.74 in chips)
Seat 5: Andr1972 ($5.66 in chips)
Seat 6: mrGold443 ($5.83 in chips)
cooller.GG: posts small blind $0.02
Baksojor: posts big blind $0.05
*** HOLE CARDS ***
Dealt to Baksojor [Ts Ac]
cryptozee: folds
Andr1972: folds
mrGold443: folds
Sobo030: folds
cooller.GG: folds
Uncalled bet ($0.03) returned to Baksojor
Baksojor collected $0.04 from pot
Baksojor: doesn't show hand
*** SUMMARY ***
Total pot $0.04 | Rake $0
Seat 1: Sobo030 (button) folded before Flop (didn't bet)
Seat 2: cooller.GG (small blind) folded before Flop
Seat 3: Baksojor (big blind) collected ($0.04)
Seat 4: cryptozee folded before Flop (didn't bet)
Seat 5: Andr1972 folded before Flop (didn't bet)
Seat 6: mrGold443 folded before Flop (didn't bet)


*********** # 90 **************
PokerStars Zoom Hand #174048524410:  Hold'em No Limit ($0.02/$0.05) - 2017/08/07 23:35:57 MSK [2017/08/07 16:35:57 ET]
Table 'Donati' 6-max Seat #1 is the button
Seat 1: elkanguro87 ($3.68 in chips)
Seat 2: Flash91ua ($6.34 in chips)
Seat 3: labus80n ($9.44 in chips)
Seat 4: Baksojor ($15.49 in chips)
Seat 5: Teflonmemory ($5.92 in chips)
Seat 6: JGold530 ($5.55 in chips)
Flash91ua: posts small blind $0.02
labus80n: posts big blind $0.05
*** HOLE CARDS ***
Dealt to Baksojor [6c Ah]
Baksojor: folds
Teflonmemory: folds
JGold530: folds
elkanguro87: raises $0.10 to $0.15
Flash91ua: folds
labus80n: folds
Uncalled bet ($0.10) returned to elkanguro87
elkanguro87 collected $0.12 from pot
elkanguro87: doesn't show hand
*** SUMMARY ***
Total pot $0.12 | Rake $0
Seat 1: elkanguro87 (button) collected ($0.12)
Seat 2: Flash91ua (small blind) folded before Flop
Seat 3: labus80n (big blind) folded before Flop
Seat 4: Baksojor folded before Flop (didn't bet)
Seat 5: Teflonmemory folded before Flop (didn't bet)
Seat 6: JGold530 folded before Flop (didn't bet)


*********** # 91 **************
PokerStars Zoom Hand #174048521273:  Hold'em No Limit ($0.02/$0.05) - 2017/08/07 23:35:53 MSK [2017/08/07 16:35:53 ET]
Table 'Donati' 6-max Seat #1 is the button
Seat 1: ajdin_188 ($3.08 in chips)
Seat 2: onootooole ($4.84 in chips)
Seat 3: bajinege ($5 in chips)
Seat 4: and_67rus ($2.72 in chips)
Seat 5: Baksojor ($15.49 in chips)
Seat 6: Sunny-Shanse ($5.15 in chips)
onootooole: posts small blind $0.02
bajinege: posts big blind $0.05
*** HOLE CARDS ***
Dealt to Baksojor [Jd 4s]
and_67rus: raises $0.05 to $0.10
Baksojor: folds
Sunny-Shanse: folds
ajdin_188: raises $2.98 to $3.08 and is all-in
onootooole: folds
bajinege: folds
and_67rus: folds
Uncalled bet ($2.98) returned to ajdin_188
ajdin_188 collected $0.27 from pot
ajdin_188: doesn't show hand
*** SUMMARY ***
Total pot $0.27 | Rake $0
Seat 1: ajdin_188 (button) collected ($0.27)
Seat 2: onootooole (small blind) folded before Flop
Seat 3: bajinege (big blind) folded before Flop
Seat 4: and_67rus folded before Flop
Seat 5: Baksojor folded before Flop (didn't bet)
Seat 6: Sunny-Shanse folded before Flop (didn't bet)


*********** # 92 **************
PokerStars Zoom Hand #174048517341:  Hold'em No Limit ($0.02/$0.05) - 2017/08/07 23:35:48 MSK [2017/08/07 16:35:48 ET]
Table 'Donati' 6-max Seat #1 is the button
Seat 1: nippesboy ($5 in chips)
Seat 2: shantaf91 ($5 in chips)
Seat 3: DDonkeyKong ($5.05 in chips)
Seat 4: Scar_spb ($5.81 in chips)
Seat 5: IVE244 ($5.92 in chips)
Seat 6: Baksojor ($15.49 in chips)
shantaf91: posts small blind $0.02
DDonkeyKong: posts big blind $0.05
*** HOLE CARDS ***
Dealt to Baksojor [9d 5h]
Scar_spb: folds
IVE244: folds
Baksojor: folds
nippesboy: raises $0.05 to $0.10
shantaf91: folds
DDonkeyKong: folds
Uncalled bet ($0.05) returned to nippesboy
nippesboy collected $0.12 from pot
nippesboy: doesn't show hand
*** SUMMARY ***
Total pot $0.12 | Rake $0
Seat 1: nippesboy (button) collected ($0.12)
Seat 2: shantaf91 (small blind) folded before Flop
Seat 3: DDonkeyKong (big blind) folded before Flop
Seat 4: Scar_spb folded before Flop (didn't bet)
Seat 5: IVE244 folded before Flop (didn't bet)
Seat 6: Baksojor folded before Flop (didn't bet)


*********** # 93 **************
PokerStars Zoom Hand #174048514146:  Hold'em No Limit ($0.02/$0.05) - 2017/08/07 23:35:44 MSK [2017/08/07 16:35:44 ET]
Table 'Donati' 6-max Seat #1 is the button
Seat 1: My4Street ($5 in chips)
Seat 2: dark h0r$e ($5 in chips)
Seat 3: disident365 ($5.42 in chips)
Seat 4: Baksojor ($15.49 in chips)
Seat 5: Sunny-Shanse ($5.15 in chips)
Seat 6: Sathar123 ($5.08 in chips)
dark h0r$e: posts small blind $0.02
disident365: posts big blind $0.05
*** HOLE CARDS ***
Dealt to Baksojor [6d Jc]
Baksojor: folds
Sunny-Shanse: folds
Sathar123: raises $0.10 to $0.15
My4Street: folds
dark h0r$e: folds
disident365: folds
Uncalled bet ($0.10) returned to Sathar123
Sathar123 collected $0.12 from pot
Sathar123: doesn't show hand
*** SUMMARY ***
Total pot $0.12 | Rake $0
Seat 1: My4Street (button) folded before Flop (didn't bet)
Seat 2: dark h0r$e (small blind) folded before Flop
Seat 3: disident365 (big blind) folded before Flop
Seat 4: Baksojor folded before Flop (didn't bet)
Seat 5: Sunny-Shanse folded before Flop (didn't bet)
Seat 6: Sathar123 collected ($0.12)


*********** # 94 **************
PokerStars Zoom Hand #174048510178:  Hold'em No Limit ($0.02/$0.05) - 2017/08/07 23:35:39 MSK [2017/08/07 16:35:39 ET]
Table 'Donati' 6-max Seat #1 is the button
Seat 1: Memusik ($5.76 in chips)
Seat 2: qk rodriguez ($5.26 in chips)
Seat 3: Propanas ($6.84 in chips)
Seat 4: Sobo030 ($5 in chips)
Seat 5: Baksojor ($15.49 in chips)
Seat 6: IVE244 ($5.92 in chips)
qk rodriguez: posts small blind $0.02
Propanas: posts big blind $0.05
*** HOLE CARDS ***
Dealt to Baksojor [3d 5s]
Sobo030: folds
Baksojor: folds
IVE244: folds
Memusik: folds
qk rodriguez: folds
Uncalled bet ($0.03) returned to Propanas
Propanas collected $0.04 from pot
Propanas: doesn't show hand
*** SUMMARY ***
Total pot $0.04 | Rake $0
Seat 1: Memusik (button) folded before Flop (didn't bet)
Seat 2: qk rodriguez (small blind) folded before Flop
Seat 3: Propanas (big blind) collected ($0.04)
Seat 4: Sobo030 folded before Flop (didn't bet)
Seat 5: Baksojor folded before Flop (didn't bet)
Seat 6: IVE244 folded before Flop (didn't bet)


*********** # 95 **************
PokerStars Zoom Hand #174048462028:  Hold'em No Limit ($0.02/$0.05) - 2017/08/07 23:34:38 MSK [2017/08/07 16:34:38 ET]
Table 'Donati' 6-max Seat #1 is the button
Seat 1: jtelgie ($2.69 in chips)
Seat 2: shantaf91 ($7.88 in chips)
Seat 3: My4Street ($6.65 in chips)
Seat 4: StephBpee ($2.70 in chips)
Seat 5: BrainGuru ($4.67 in chips)
Seat 6: Baksojor ($15.71 in chips)
shantaf91: posts small blind $0.02
My4Street: posts big blind $0.05
*** HOLE CARDS ***
Dealt to Baksojor [9s As]
StephBpee: raises $0.05 to $0.10
BrainGuru: folds
Baksojor: calls $0.10
jtelgie: folds
shantaf91: folds
My4Street: calls $0.05
*** FLOP *** [Ts 4s 5c]
My4Street: checks
StephBpee: bets $0.12
Baksojor: calls $0.12
My4Street: calls $0.12
*** TURN *** [Ts 4s 5c] [2d]
My4Street: checks
StephBpee: checks
Baksojor: checks
*** RIVER *** [Ts 4s 5c 2d] [Kc]
My4Street: checks
StephBpee: checks
Baksojor: checks
*** SHOW DOWN ***
My4Street: shows [7d 6s] (high card King)
StephBpee: shows [Ac Jd] (high card Ace)
Baksojor: mucks hand
StephBpee collected $0.65 from pot
*** SUMMARY ***
Total pot $0.68 | Rake $0.03
Board [Ts 4s 5c 2d Kc]
Seat 1: jtelgie (button) folded before Flop (didn't bet)
Seat 2: shantaf91 (small blind) folded before Flop
Seat 3: My4Street (big blind) showed [7d 6s] and lost with high card King
Seat 4: StephBpee showed [Ac Jd] and won ($0.65) with high card Ace
Seat 5: BrainGuru folded before Flop (didn't bet)
Seat 6: Baksojor mucked [9s As]


*********** # 96 **************
PokerStars Zoom Hand #174048457340:  Hold'em No Limit ($0.02/$0.05) - 2017/08/07 23:34:32 MSK [2017/08/07 16:34:32 ET]
Table 'Donati' 6-max Seat #1 is the button
Seat 1: twiceAweek ($4.26 in chips)
Seat 2: AlberTSifon ($5.31 in chips)
Seat 3: Baksojor ($15.76 in chips)
Seat 4: nodarik1980 ($5.20 in chips)
Seat 5: kot615 ($1.65 in chips)
Seat 6: Swing1025 ($48.53 in chips)
AlberTSifon: posts small blind $0.02
Baksojor: posts big blind $0.05
*** HOLE CARDS ***
Dealt to Baksojor [Kd 3c]
nodarik1980: raises $0.10 to $0.15
kot615: folds
Swing1025: folds
twiceAweek: folds
AlberTSifon: folds
Baksojor: folds
Uncalled bet ($0.10) returned to nodarik1980
nodarik1980 collected $0.12 from pot
nodarik1980: doesn't show hand
*** SUMMARY ***
Total pot $0.12 | Rake $0
Seat 1: twiceAweek (button) folded before Flop (didn't bet)
Seat 2: AlberTSifon (small blind) folded before Flop
Seat 3: Baksojor (big blind) folded before Flop
Seat 4: nodarik1980 collected ($0.12)
Seat 5: kot615 folded before Flop (didn't bet)
Seat 6: Swing1025 folded before Flop (didn't bet)


*********** # 97 **************
PokerStars Zoom Hand #174048454061:  Hold'em No Limit ($0.02/$0.05) - 2017/08/07 23:34:28 MSK [2017/08/07 16:34:28 ET]
Table 'Donati' 6-max Seat #1 is the button
Seat 1: Droncha ($4.93 in chips)
Seat 2: Baksojor ($15.78 in chips)
Seat 3: Toffsla ($8.93 in chips)
Seat 4: Roman250776 ($2.32 in chips)
Seat 5: qk rodriguez ($5.31 in chips)
Seat 6: Scar_spb ($5.46 in chips)
Baksojor: posts small blind $0.02
Toffsla: posts big blind $0.05
*** HOLE CARDS ***
Dealt to Baksojor [Ts 4c]
Roman250776: raises $0.10 to $0.15
qk rodriguez: folds
Scar_spb: folds
Droncha: calls $0.15
Baksojor: folds
Toffsla: folds
*** FLOP *** [6c 5d 6h]
Roman250776: bets $0.05
Droncha: folds
Uncalled bet ($0.05) returned to Roman250776
Roman250776 collected $0.35 from pot
Roman250776: doesn't show hand
*** SUMMARY ***
Total pot $0.37 | Rake $0.02
Board [6c 5d 6h]
Seat 1: Droncha (button) folded on the Flop
Seat 2: Baksojor (small blind) folded before Flop
Seat 3: Toffsla (big blind) folded before Flop
Seat 4: Roman250776 collected ($0.35)
Seat 5: qk rodriguez folded before Flop (didn't bet)
Seat 6: Scar_spb folded before Flop (didn't bet)


*********** # 98 **************
PokerStars Zoom Hand #174048446070:  Hold'em No Limit ($0.02/$0.05) - 2017/08/07 23:34:18 MSK [2017/08/07 16:34:18 ET]
Table 'Donati' 6-max Seat #1 is the button
Seat 1: Baksojor ($15.78 in chips)
Seat 2: Panag88 ($5 in chips)
Seat 3: Dava 0060 ($5 in chips)
Seat 4: My4Street ($5 in chips)
Seat 5: mag2110 ($3.64 in chips)
Seat 6: Fujfuj_Mele ($4.06 in chips)
Panag88: posts small blind $0.02
Dava 0060: posts big blind $0.05
*** HOLE CARDS ***
Dealt to Baksojor [2d 6s]
My4Street: folds
mag2110: raises $0.10 to $0.15
Fujfuj_Mele: folds
Baksojor: folds
Panag88: folds
Dava 0060: folds
Uncalled bet ($0.10) returned to mag2110
mag2110 collected $0.12 from pot
mag2110: doesn't show hand
*** SUMMARY ***
Total pot $0.12 | Rake $0
Seat 1: Baksojor (button) folded before Flop (didn't bet)
Seat 2: Panag88 (small blind) folded before Flop
Seat 3: Dava 0060 (big blind) folded before Flop
Seat 4: My4Street folded before Flop (didn't bet)
Seat 5: mag2110 collected ($0.12)
Seat 6: Fujfuj_Mele folded before Flop (didn't bet)


*********** # 99 **************
PokerStars Zoom Hand #174048435795:  Hold'em No Limit ($0.02/$0.05) - 2017/08/07 23:34:05 MSK [2017/08/07 16:34:05 ET]
Table 'Donati' 6-max Seat #1 is the button
Seat 1: P.J.Shaytan ($5.20 in chips)
Seat 2: GiorgosZ.90 ($5.43 in chips)
Seat 3: nitzed12 ($5 in chips)
Seat 4: Baksojor ($15.78 in chips)
Seat 5: ajdin_188 ($2.54 in chips)
Seat 6: sadok85 ($4.40 in chips)
GiorgosZ.90: posts small blind $0.02
nitzed12: posts big blind $0.05
*** HOLE CARDS ***
Dealt to Baksojor [As 9d]
Baksojor: folds
ajdin_188: folds
sadok85: folds
P.J.Shaytan: raises $0.10 to $0.15
GiorgosZ.90: folds
nitzed12: folds
Uncalled bet ($0.10) returned to P.J.Shaytan
P.J.Shaytan collected $0.12 from pot
P.J.Shaytan: doesn't show hand
*** SUMMARY ***
Total pot $0.12 | Rake $0
Seat 1: P.J.Shaytan (button) collected ($0.12)
Seat 2: GiorgosZ.90 (small blind) folded before Flop
Seat 3: nitzed12 (big blind) folded before Flop
Seat 4: Baksojor folded before Flop (didn't bet)
Seat 5: ajdin_188 folded before Flop (didn't bet)
Seat 6: sadok85 folded before Flop (didn't bet)


*********** # 100 **************
PokerStars Zoom Hand #174048421543:  Hold'em No Limit ($0.02/$0.05) - 2017/08/07 23:33:47 MSK [2017/08/07 16:33:47 ET]
Table 'Donati' 6-max Seat #1 is the button
Seat 1: Oberon63 ($5.07 in chips)
Seat 2: suebar ($2.98 in chips)
Seat 3: FAHHH168 ($5.12 in chips)
Seat 4: Jack123985 ($5.71 in chips)
Seat 5: Udart ($9.68 in chips)
Seat 6: Baksojor ($15.78 in chips)
suebar: posts small blind $0.02
FAHHH168: posts big blind $0.05
*** HOLE CARDS ***
Dealt to Baksojor [Td Qh]
Jack123985: raises $0.10 to $0.15
Udart: folds
Baksojor: folds
Oberon63: folds
suebar: folds
FAHHH168: folds
Uncalled bet ($0.10) returned to Jack123985
Jack123985 collected $0.12 from pot
Jack123985: doesn't show hand
*** SUMMARY ***
Total pot $0.12 | Rake $0
Seat 1: Oberon63 (button) folded before Flop (didn't bet)
Seat 2: suebar (small blind) folded before Flop
Seat 3: FAHHH168 (big blind) folded before Flop
Seat 4: Jack123985 collected ($0.12)
Seat 5: Udart folded before Flop (didn't bet)
Seat 6: Baksojor folded before Flop (didn't bet)


*********** # 101 **************
PokerStars Zoom Hand #174048397951:  Hold'em No Limit ($0.02/$0.05) - 2017/08/07 23:33:17 MSK [2017/08/07 16:33:17 ET]
Table 'Donati' 6-max Seat #1 is the button
Seat 1: ksrepin ($13.05 in chips)
Seat 2: chraeder ($4.28 in chips)
Seat 3: Baksojor ($15.76 in chips)
Seat 4: deltamikey ($5 in chips)
Seat 5: V.S.151 ($7.28 in chips)
Seat 6: Grario ($9.48 in chips)
chraeder: posts small blind $0.02
Baksojor: posts big blind $0.05
*** HOLE CARDS ***
Dealt to Baksojor [Jc Ac]
deltamikey: folds
V.S.151: folds
Grario: folds
ksrepin: folds
chraeder: folds
Uncalled bet ($0.03) returned to Baksojor
Baksojor collected $0.04 from pot
Baksojor: doesn't show hand
*** SUMMARY ***
Total pot $0.04 | Rake $0
Seat 1: ksrepin (button) folded before Flop (didn't bet)
Seat 2: chraeder (small blind) folded before Flop
Seat 3: Baksojor (big blind) collected ($0.04)
Seat 4: deltamikey folded before Flop (didn't bet)
Seat 5: V.S.151 folded before Flop (didn't bet)
Seat 6: Grario folded before Flop (didn't bet)


*********** # 102 **************
PokerStars Zoom Hand #174048394820:  Hold'em No Limit ($0.02/$0.05) - 2017/08/07 23:33:13 MSK [2017/08/07 16:33:13 ET]
Table 'Donati' 6-max Seat #1 is the button
Seat 1: InteRus13 ($4.20 in chips)
Seat 2: Baksojor ($15.78 in chips)
Seat 3: Dava 0060 ($5 in chips)
Seat 4: kuzima_ge ($5.50 in chips)
Seat 5: nordwolf27 ($5.34 in chips)
Seat 6: guadz ($5 in chips)
Baksojor: posts small blind $0.02
Dava 0060: posts big blind $0.05
*** HOLE CARDS ***
Dealt to Baksojor [6c Jh]
kuzima_ge: folds
nordwolf27: folds
guadz: folds
InteRus13: raises $0.10 to $0.15
Baksojor: folds
Dava 0060: calls $0.10
*** FLOP *** [Td 3d 5h]
Dava 0060: checks
InteRus13: checks
*** TURN *** [Td 3d 5h] [Kh]
Dava 0060: checks
InteRus13: bets $0.24
Dava 0060: calls $0.24
*** RIVER *** [Td 3d 5h Kh] [Ks]
Dava 0060: checks
InteRus13: checks
*** SHOW DOWN ***
Dava 0060: shows [Jd Qs] (a pair of Kings)
InteRus13: shows [Ad Qc] (a pair of Kings - Ace kicker)
InteRus13 collected $0.77 from pot
*** SUMMARY ***
Total pot $0.80 | Rake $0.03
Board [Td 3d 5h Kh Ks]
Seat 1: InteRus13 (button) showed [Ad Qc] and won ($0.77) with a pair of Kings
Seat 2: Baksojor (small blind) folded before Flop
Seat 3: Dava 0060 (big blind) showed [Jd Qs] and lost with a pair of Kings
Seat 4: kuzima_ge folded before Flop (didn't bet)
Seat 5: nordwolf27 folded before Flop (didn't bet)
Seat 6: guadz folded before Flop (didn't bet)


*********** # 103 **************
PokerStars Zoom Hand #174048368687:  Hold'em No Limit ($0.02/$0.05) - 2017/08/07 23:32:40 MSK [2017/08/07 16:32:40 ET]
Table 'Donati' 6-max Seat #1 is the button
Seat 1: Baksojor ($15.93 in chips)
Seat 2: L.I.N.1989 ($5 in chips)
Seat 3: chraeder ($4.32 in chips)
Seat 4: P3tz91 ($9.81 in chips)
Seat 5: MiyagiMaster ($5.07 in chips)
Seat 6: t$unami cr ($5.06 in chips)
L.I.N.1989: posts small blind $0.02
chraeder: posts big blind $0.05
*** HOLE CARDS ***
Dealt to Baksojor [8h 9h]
P3tz91: raises $0.10 to $0.15
MiyagiMaster: folds
t$unami cr: folds
Baksojor: calls $0.15
L.I.N.1989: folds
chraeder: folds
*** FLOP *** [7s Qs 4d]
P3tz91: bets $0.23
Baksojor: folds
Uncalled bet ($0.23) returned to P3tz91
P3tz91 collected $0.35 from pot
P3tz91: doesn't show hand
*** SUMMARY ***
Total pot $0.37 | Rake $0.02
Board [7s Qs 4d]
Seat 1: Baksojor (button) folded on the Flop
Seat 2: L.I.N.1989 (small blind) folded before Flop
Seat 3: chraeder (big blind) folded before Flop
Seat 4: P3tz91 collected ($0.35)
Seat 5: MiyagiMaster folded before Flop (didn't bet)
Seat 6: t$unami cr folded before Flop (didn't bet)


*********** # 104 **************
PokerStars Zoom Hand #174048357748:  Hold'em No Limit ($0.02/$0.05) - 2017/08/07 23:32:26 MSK [2017/08/07 16:32:26 ET]
Table 'Donati' 6-max Seat #1 is the button
Seat 1: B0GEYMAN ($5 in chips)
Seat 2: hen1337 ($5.09 in chips)
Seat 3: Oscar__62176 ($5.05 in chips)
Seat 4: Baksojor ($15.86 in chips)
Seat 5: Al3xRoyal27 ($4.66 in chips)
Seat 6: booshrut ($5 in chips)
hen1337: posts small blind $0.02
Oscar__62176: posts big blind $0.05
*** HOLE CARDS ***
Dealt to Baksojor [Ks Ac]
Baksojor: raises $0.10 to $0.15
Al3xRoyal27: folds
booshrut: folds
B0GEYMAN: folds
hen1337: folds
Oscar__62176: folds
Uncalled bet ($0.10) returned to Baksojor
Baksojor collected $0.12 from pot
Baksojor: doesn't show hand
*** SUMMARY ***
Total pot $0.12 | Rake $0
Seat 1: B0GEYMAN (button) folded before Flop (didn't bet)
Seat 2: hen1337 (small blind) folded before Flop
Seat 3: Oscar__62176 (big blind) folded before Flop
Seat 4: Baksojor collected ($0.12)
Seat 5: Al3xRoyal27 folded before Flop (didn't bet)
Seat 6: booshrut folded before Flop (didn't bet)


*********** # 105 **************
PokerStars Zoom Hand #174048354757:  Hold'em No Limit ($0.02/$0.05) - 2017/08/07 23:32:22 MSK [2017/08/07 16:32:22 ET]
Table 'Donati' 6-max Seat #1 is the button
Seat 1: Best5555 ($5.09 in chips)
Seat 2: luis seifer ($1.79 in chips)
Seat 3: chilloutrich ($5.46 in chips)
Seat 4: avg35 ($5.07 in chips)
Seat 5: Baksojor ($15.86 in chips)
Seat 6: and_67rus ($3.53 in chips)
luis seifer: posts small blind $0.02
chilloutrich: posts big blind $0.05
*** HOLE CARDS ***
Dealt to Baksojor [2s Qd]
avg35: folds
Baksojor: folds
and_67rus: folds
Best5555: folds
luis seifer: calls $0.03
chilloutrich: checks
*** FLOP *** [5c 8d Js]
luis seifer: checks
chilloutrich: bets $0.10
luis seifer: folds
Uncalled bet ($0.10) returned to chilloutrich
chilloutrich collected $0.10 from pot
chilloutrich: doesn't show hand
*** SUMMARY ***
Total pot $0.10 | Rake $0
Board [5c 8d Js]
Seat 1: Best5555 (button) folded before Flop (didn't bet)
Seat 2: luis seifer (small blind) folded on the Flop
Seat 3: chilloutrich (big blind) collected ($0.10)
Seat 4: avg35 folded before Flop (didn't bet)
Seat 5: Baksojor folded before Flop (didn't bet)
Seat 6: and_67rus folded before Flop (didn't bet)


*********** # 106 **************
PokerStars Zoom Hand #174048352383:  Hold'em No Limit ($0.02/$0.05) - 2017/08/07 23:32:19 MSK [2017/08/07 16:32:19 ET]
Table 'Donati' 6-max Seat #1 is the button
Seat 1: begze ($2.09 in chips)
Seat 2: Baksojor ($15.88 in chips)
Seat 3: kscloud ($5.65 in chips)
Seat 4: hen1337 ($5.09 in chips)
Seat 5: Savva08 ($5.89 in chips)
Seat 6: EggMayo ($5 in chips)
Baksojor: posts small blind $0.02
kscloud: posts big blind $0.05
*** HOLE CARDS ***
Dealt to Baksojor [2s 9h]
hen1337: folds
Savva08: folds
EggMayo: folds
begze: folds
Baksojor: folds
Uncalled bet ($0.03) returned to kscloud
kscloud collected $0.04 from pot
kscloud: doesn't show hand
*** SUMMARY ***
Total pot $0.04 | Rake $0
Seat 1: begze (button) folded before Flop (didn't bet)
Seat 2: Baksojor (small blind) folded before Flop
Seat 3: kscloud (big blind) collected ($0.04)
Seat 4: hen1337 folded before Flop (didn't bet)
Seat 5: Savva08 folded before Flop (didn't bet)
Seat 6: EggMayo folded before Flop (didn't bet)


*********** # 107 **************
PokerStars Zoom Hand #174048346815:  Hold'em No Limit ($0.02/$0.05) - 2017/08/07 23:32:12 MSK [2017/08/07 16:32:12 ET]
Table 'Donati' 6-max Seat #1 is the button
Seat 1: aokps60 ($4.31 in chips)
Seat 2: t$unami cr ($6.86 in chips)
Seat 3: Baksojor ($15.93 in chips)
Seat 4: mag2110 ($1.94 in chips)
Seat 5: Droncha ($4.81 in chips)
Seat 6: dark h0r$e ($5 in chips)
t$unami cr: posts small blind $0.02
Baksojor: posts big blind $0.05
*** HOLE CARDS ***
Dealt to Baksojor [Jd 4s]
mag2110: raises $0.10 to $0.15
Droncha: folds
dark h0r$e: folds
aokps60: folds
t$unami cr: calls $0.13
Baksojor: folds
*** FLOP *** [6s Qh 5h]
t$unami cr: checks
mag2110: checks
*** TURN *** [6s Qh 5h] [2d]
t$unami cr: bets $0.19
mag2110: folds
Uncalled bet ($0.19) returned to t$unami cr
t$unami cr collected $0.34 from pot
t$unami cr: doesn't show hand
*** SUMMARY ***
Total pot $0.35 | Rake $0.01
Board [6s Qh 5h 2d]
Seat 1: aokps60 (button) folded before Flop (didn't bet)
Seat 2: t$unami cr (small blind) collected ($0.34)
Seat 3: Baksojor (big blind) folded before Flop
Seat 4: mag2110 folded on the Turn
Seat 5: Droncha folded before Flop (didn't bet)
Seat 6: dark h0r$e folded before Flop (didn't bet)


*********** # 108 **************
PokerStars Zoom Hand #174048343706:  Hold'em No Limit ($0.02/$0.05) - 2017/08/07 23:32:08 MSK [2017/08/07 16:32:08 ET]
Table 'Donati' 6-max Seat #1 is the button
Seat 1: donn1987 ($6.58 in chips)
Seat 2: Master_Ad776 ($5 in chips)
Seat 3: xizza ($8.21 in chips)
Seat 4: spirosz1000 ($4.83 in chips)
Seat 5: Baksojor ($15.93 in chips)
Seat 6: Osiris7567 ($6.82 in chips)
Master_Ad776: posts small blind $0.02
xizza: posts big blind $0.05
*** HOLE CARDS ***
Dealt to Baksojor [Td 2d]
spirosz1000: folds
Baksojor: folds
Osiris7567: folds
donn1987: folds
Master_Ad776: folds
Uncalled bet ($0.03) returned to xizza
xizza collected $0.04 from pot
xizza: doesn't show hand
*** SUMMARY ***
Total pot $0.04 | Rake $0
Seat 1: donn1987 (button) folded before Flop (didn't bet)
Seat 2: Master_Ad776 (small blind) folded before Flop
Seat 3: xizza (big blind) collected ($0.04)
Seat 4: spirosz1000 folded before Flop (didn't bet)
Seat 5: Baksojor folded before Flop (didn't bet)
Seat 6: Osiris7567 folded before Flop (didn't bet)


*********** # 109 **************
PokerStars Zoom Hand #174048327762:  Hold'em No Limit ($0.02/$0.05) - 2017/08/07 23:31:48 MSK [2017/08/07 16:31:48 ET]
Table 'Donati' 6-max Seat #1 is the button
Seat 1: Baksojor ($15.86 in chips)
Seat 2: Ngroski ($6.04 in chips)
Seat 3: P3tz91 ($9.86 in chips)
Seat 4: SNAGATA22 ($7.08 in chips)
Seat 5: anonimowa.m ($5.99 in chips)
Seat 6: ferreous26 ($2.62 in chips)
Ngroski: posts small blind $0.02
P3tz91: posts big blind $0.05
*** HOLE CARDS ***
Dealt to Baksojor [Kh Td]
SNAGATA22: folds
anonimowa.m: folds
ferreous26: folds
Baksojor: raises $0.05 to $0.10
Ngroski: folds
P3tz91: folds
Uncalled bet ($0.05) returned to Baksojor
Baksojor collected $0.12 from pot
Baksojor: doesn't show hand
*** SUMMARY ***
Total pot $0.12 | Rake $0
Seat 1: Baksojor (button) collected ($0.12)
Seat 2: Ngroski (small blind) folded before Flop
Seat 3: P3tz91 (big blind) folded before Flop
Seat 4: SNAGATA22 folded before Flop (didn't bet)
Seat 5: anonimowa.m folded before Flop (didn't bet)
Seat 6: ferreous26 folded before Flop (didn't bet)


*********** # 110 **************
PokerStars Zoom Hand #174048292290:  Hold'em No Limit ($0.02/$0.05) - 2017/08/07 23:31:03 MSK [2017/08/07 16:31:03 ET]
Table 'Donati' 6-max Seat #1 is the button
Seat 1: Frodu46 ($5.28 in chips)
Seat 2: MSKLucky007 ($5.28 in chips)
Seat 3: Naosky ($11.54 in chips)
Seat 4: Baksojor ($15.43 in chips)
Seat 5: BunicuStie ($6.41 in chips)
Seat 6: InteRus13 ($5.76 in chips)
MSKLucky007: posts small blind $0.02
Naosky: posts big blind $0.05
*** HOLE CARDS ***
Dealt to Baksojor [Kd Ac]
Baksojor: raises $0.10 to $0.15
BunicuStie: calls $0.15
InteRus13: folds
Frodu46: folds
MSKLucky007: folds
Naosky: folds
*** FLOP *** [Jc Qh Th]
Baksojor: bets $0.25
BunicuStie: calls $0.25
*** TURN *** [Jc Qh Th] [Ts]
Baksojor: bets $0.65
BunicuStie: folds
Uncalled bet ($0.65) returned to Baksojor
Baksojor collected $0.83 from pot
Baksojor: doesn't show hand
*** SUMMARY ***
Total pot $0.87 | Rake $0.04
Board [Jc Qh Th Ts]
Seat 1: Frodu46 (button) folded before Flop (didn't bet)
Seat 2: MSKLucky007 (small blind) folded before Flop
Seat 3: Naosky (big blind) folded before Flop
Seat 4: Baksojor collected ($0.83)
Seat 5: BunicuStie folded on the Turn
Seat 6: InteRus13 folded before Flop (didn't bet)


*********** # 111 **************
PokerStars Zoom Hand #174048279552:  Hold'em No Limit ($0.02/$0.05) - 2017/08/07 23:30:47 MSK [2017/08/07 16:30:47 ET]
Table 'Donati' 6-max Seat #1 is the button
Seat 1: Demon31222 ($5.12 in chips)
Seat 2: kicks4living ($5 in chips)
Seat 3: b72rus ($6.59 in chips)
Seat 4: IVE244 ($5 in chips)
Seat 5: boksiukas ($6.09 in chips)
Seat 6: Baksojor ($15.36 in chips)
kicks4living: posts small blind $0.02
b72rus: posts big blind $0.05
*** HOLE CARDS ***
Dealt to Baksojor [7d 8h]
IVE244: folds
boksiukas: folds
Baksojor: raises $0.07 to $0.12
Demon31222: folds
kicks4living: folds
b72rus: folds
Uncalled bet ($0.07) returned to Baksojor
Baksojor collected $0.12 from pot
Baksojor: doesn't show hand
*** SUMMARY ***
Total pot $0.12 | Rake $0
Seat 1: Demon31222 (button) folded before Flop (didn't bet)
Seat 2: kicks4living (small blind) folded before Flop
Seat 3: b72rus (big blind) folded before Flop
Seat 4: IVE244 folded before Flop (didn't bet)
Seat 5: boksiukas folded before Flop (didn't bet)
Seat 6: Baksojor collected ($0.12)


*********** # 112 **************
PokerStars Zoom Hand #174048276510:  Hold'em No Limit ($0.02/$0.05) - 2017/08/07 23:30:43 MSK [2017/08/07 16:30:43 ET]
Table 'Donati' 6-max Seat #1 is the button
Seat 1: ksrepin ($2.97 in chips)
Seat 2: gehcastro ($7.59 in chips)
Seat 3: ElbowsKnees ($5.51 in chips)
Seat 4: Baksojor ($15.36 in chips)
Seat 5: cleyton352 ($4.51 in chips)
Seat 6: Al3xRoyal27 ($4.61 in chips)
gehcastro: posts small blind $0.02
ElbowsKnees: posts big blind $0.05
*** HOLE CARDS ***
Dealt to Baksojor [5c Ks]
Baksojor: folds
cleyton352: folds
Al3xRoyal27: folds
ksrepin: folds
gehcastro: raises $0.10 to $0.15
ElbowsKnees: raises $0.30 to $0.45
gehcastro: raises $7.14 to $7.59 and is all-in
ElbowsKnees: calls $5.06 and is all-in
Uncalled bet ($2.08) returned to gehcastro
*** FIRST FLOP *** [Ah Ts 8d]
*** FIRST TURN *** [Ah Ts 8d] [Qd]
*** FIRST RIVER *** [Ah Ts 8d Qd] [4c]
*** SECOND FLOP *** [Jh 2s Td]
*** SECOND TURN *** [Jh 2s Td] [8c]
*** SECOND RIVER *** [Jh 2s Td 8c] [9d]
*** FIRST SHOW DOWN ***
gehcastro: shows [Qc Qs] (three of a kind, Queens)
ElbowsKnees: shows [As Kh] (a pair of Aces)
gehcastro collected $5.28 from pot
*** SECOND SHOW DOWN ***
gehcastro: shows [Qc Qs] (a straight, Eight to Queen)
ElbowsKnees: shows [As Kh] (high card Ace)
gehcastro collected $5.28 from pot
*** SUMMARY ***
Total pot $11.02 | Rake $0.46
Hand was run twice
FIRST Board [Ah Ts 8d Qd 4c]
SECOND Board [Jh 2s Td 8c 9d]
Seat 1: ksrepin (button) folded before Flop (didn't bet)
Seat 2: gehcastro (small blind) showed [Qc Qs] and won ($5.28) with three of a kind, Queens, and won ($5.28) with a straight, Eight to Queen
Seat 3: ElbowsKnees (big blind) showed [As Kh] and lost with a pair of Aces, and lost with high card Ace
Seat 4: Baksojor folded before Flop (didn't bet)
Seat 5: cleyton352 folded before Flop (didn't bet)
Seat 6: Al3xRoyal27 folded before Flop (didn't bet)


*********** # 113 **************
PokerStars Zoom Hand #174048274204:  Hold'em No Limit ($0.02/$0.05) - 2017/08/07 23:30:40 MSK [2017/08/07 16:30:40 ET]
Table 'Donati' 6-max Seat #1 is the button
Seat 1: P3tz91 ($11.50 in chips)
Seat 2: Baksojor ($15.38 in chips)
Seat 3: Faraon1207 ($5.87 in chips)
Seat 4: gl1oblastr ($6.71 in chips)
Seat 5: rockycool04 ($6.66 in chips)
Seat 6: wasteman999 ($2.81 in chips)
Baksojor: posts small blind $0.02
Faraon1207: posts big blind $0.05
*** HOLE CARDS ***
Dealt to Baksojor [2s Th]
gl1oblastr: folds
rockycool04: folds
wasteman999: calls $0.05
P3tz91: raises $0.15 to $0.20
Baksojor: folds
Faraon1207: folds
wasteman999: calls $0.15
*** FLOP *** [4h 8h 8c]
wasteman999: bets $0.05
P3tz91: raises $0.28 to $0.33
wasteman999: raises $0.28 to $0.61
P3tz91: calls $0.28
*** TURN *** [4h 8h 8c] [2c]
wasteman999: bets $0.05
P3tz91: calls $0.05
*** RIVER *** [4h 8h 8c 2c] [Qh]
wasteman999: bets $0.85
P3tz91: calls $0.85
*** SHOW DOWN ***
wasteman999: shows [3h Kh] (a flush, King high)
P3tz91: mucks hand
wasteman999 collected $3.35 from pot
*** SUMMARY ***
Total pot $3.49 | Rake $0.14
Board [4h 8h 8c 2c Qh]
Seat 1: P3tz91 (button) mucked [Ah Ac]
Seat 2: Baksojor (small blind) folded before Flop
Seat 3: Faraon1207 (big blind) folded before Flop
Seat 4: gl1oblastr folded before Flop (didn't bet)
Seat 5: rockycool04 folded before Flop (didn't bet)
Seat 6: wasteman999 showed [3h Kh] and won ($3.35) with a flush, King high


*********** # 114 **************
PokerStars Zoom Hand #174048263880:  Hold'em No Limit ($0.02/$0.05) - 2017/08/07 23:30:27 MSK [2017/08/07 16:30:27 ET]
Table 'Donati' 6-max Seat #1 is the button
Seat 1: Aleks Ryder ($8.21 in chips)
Seat 2: RADemetrio ($7.26 in chips)
Seat 3: Baksojor ($15.43 in chips)
Seat 4: P3tz91 ($11.52 in chips)
Seat 5: kicks4living ($5 in chips)
Seat 6: xizza ($11.71 in chips)
RADemetrio: posts small blind $0.02
Baksojor: posts big blind $0.05
*** HOLE CARDS ***
Dealt to Baksojor [9s 6h]
P3tz91: folds
kicks4living: folds
xizza: raises $0.10 to $0.15
Aleks Ryder: folds
RADemetrio: folds
Baksojor: folds
Uncalled bet ($0.10) returned to xizza
xizza collected $0.12 from pot
xizza: doesn't show hand
*** SUMMARY ***
Total pot $0.12 | Rake $0
Seat 1: Aleks Ryder (button) folded before Flop (didn't bet)
Seat 2: RADemetrio (small blind) folded before Flop
Seat 3: Baksojor (big blind) folded before Flop
Seat 4: P3tz91 folded before Flop (didn't bet)
Seat 5: kicks4living folded before Flop (didn't bet)
Seat 6: xizza collected ($0.12)


*********** # 115 **************
PokerStars Zoom Hand #174048260725:  Hold'em No Limit ($0.02/$0.05) - 2017/08/07 23:30:23 MSK [2017/08/07 16:30:23 ET]
Table 'Donati' 6-max Seat #1 is the button
Seat 1: Girigal ($5.07 in chips)
Seat 2: Gederts ($3.01 in chips)
Seat 3: Memusik ($5.69 in chips)
Seat 4: YmanB ($7.87 in chips)
Seat 5: Baksojor ($15.43 in chips)
Seat 6: onootooole ($3.87 in chips)
Gederts: posts small blind $0.02
Memusik: posts big blind $0.05
*** HOLE CARDS ***
Dealt to Baksojor [6s Jh]
YmanB: folds
Baksojor: folds
onootooole: raises $0.75 to $0.80
Girigal: folds
Gederts: folds
Memusik: folds
Uncalled bet ($0.75) returned to onootooole
onootooole collected $0.12 from pot
onootooole: doesn't show hand
*** SUMMARY ***
Total pot $0.12 | Rake $0
Seat 1: Girigal (button) folded before Flop (didn't bet)
Seat 2: Gederts (small blind) folded before Flop
Seat 3: Memusik (big blind) folded before Flop
Seat 4: YmanB folded before Flop (didn't bet)
Seat 5: Baksojor folded before Flop (didn't bet)
Seat 6: onootooole collected ($0.12)


*********** # 116 **************
PokerStars Zoom Hand #174048209436:  Hold'em No Limit ($0.02/$0.05) - 2017/08/07 23:29:18 MSK [2017/08/07 16:29:18 ET]
Table 'Donati' 6-max Seat #1 is the button
Seat 1: Baksojor ($15.83 in chips)
Seat 2: giggell20 ($4.60 in chips)
Seat 3: MaxCrown777 ($5 in chips)
Seat 4: Naosky ($5.07 in chips)
Seat 5: Morgot339 ($7.95 in chips)
Seat 6: Dasha_1989 ($5.32 in chips)
giggell20: posts small blind $0.02
MaxCrown777: posts big blind $0.05
*** HOLE CARDS ***
Dealt to Baksojor [Ah Jh]
Naosky: folds
Morgot339: folds
Dasha_1989: raises $0.07 to $0.12
Baksojor: raises $0.28 to $0.40
giggell20: calls $0.38
MaxCrown777: calls $0.35
Dasha_1989: calls $0.28
*** FLOP *** [Kh 2d 8d]
giggell20: checks
MaxCrown777: checks
Dasha_1989: checks
Baksojor: checks
*** TURN *** [Kh 2d 8d] [4c]
giggell20: bets $0.75
MaxCrown777: calls $0.75
Dasha_1989: folds
Baksojor: folds
*** RIVER *** [Kh 2d 8d 4c] [7c]
giggell20: checks
MaxCrown777: checks
*** SHOW DOWN ***
giggell20: shows [2s Ac] (a pair of Deuces)
MaxCrown777: shows [6h 7h] (a pair of Sevens)
MaxCrown777 collected $2.97 from pot
*** SUMMARY ***
Total pot $3.10 | Rake $0.13
Board [Kh 2d 8d 4c 7c]
Seat 1: Baksojor (button) folded on the Turn
Seat 2: giggell20 (small blind) showed [2s Ac] and lost with a pair of Deuces
Seat 3: MaxCrown777 (big blind) showed [6h 7h] and won ($2.97) with a pair of Sevens
Seat 4: Naosky folded before Flop (didn't bet)
Seat 5: Morgot339 folded before Flop (didn't bet)
Seat 6: Dasha_1989 folded on the Turn


*********** # 117 **************
PokerStars Zoom Hand #174048206324:  Hold'em No Limit ($0.02/$0.05) - 2017/08/07 23:29:14 MSK [2017/08/07 16:29:14 ET]
Table 'Donati' 6-max Seat #1 is the button
Seat 1: AndreyK11 ($11.21 in chips)
Seat 2: dragonek1988 ($5.58 in chips)
Seat 3: Mak.Alse ($5.22 in chips)
Seat 4: xizza ($5.82 in chips)
Seat 5: tursows ($8.94 in chips)
Seat 6: Baksojor ($15.83 in chips)
dragonek1988: posts small blind $0.02
Mak.Alse: posts big blind $0.05
*** HOLE CARDS ***
Dealt to Baksojor [2d Kh]
xizza: folds
tursows: folds
Baksojor: folds
AndreyK11: raises $0.05 to $0.10
dragonek1988 is disconnected
dragonek1988 is connected
dragonek1988: folds
Mak.Alse: calls $0.05
*** FLOP *** [7d 5h Js]
Mak.Alse: checks
AndreyK11: bets $0.16
Mak.Alse has timed out
Mak.Alse: folds
Uncalled bet ($0.16) returned to AndreyK11
AndreyK11 collected $0.21 from pot
AndreyK11: doesn't show hand
*** SUMMARY ***
Total pot $0.22 | Rake $0.01
Board [7d 5h Js]
Seat 1: AndreyK11 (button) collected ($0.21)
Seat 2: dragonek1988 (small blind) folded before Flop
Seat 3: Mak.Alse (big blind) folded on the Flop
Seat 4: xizza folded before Flop (didn't bet)
Seat 5: tursows folded before Flop (didn't bet)
Seat 6: Baksojor folded before Flop (didn't bet)


*********** # 118 **************
PokerStars Zoom Hand #174048199071:  Hold'em No Limit ($0.02/$0.05) - 2017/08/07 23:29:05 MSK [2017/08/07 16:29:05 ET]
Table 'Donati' 6-max Seat #1 is the button
Seat 1: donn1987 ($3.61 in chips)
Seat 2: Baksojor ($15.85 in chips)
Seat 3: Make Gains ($5.13 in chips)
Seat 4: Best5555 ($5 in chips)
Seat 5: NoSmokinggg ($8.45 in chips)
Seat 6: nodarik1980 ($5.05 in chips)
Baksojor: posts small blind $0.02
Make Gains: posts big blind $0.05
*** HOLE CARDS ***
Dealt to Baksojor [Ks Jd]
Best5555: raises $0.08 to $0.13
NoSmokinggg: folds
nodarik1980: folds
donn1987: folds
Baksojor: folds
Make Gains: raises $0.37 to $0.50
Best5555: calls $0.37
*** FLOP *** [5d Ah 3h]
Make Gains: checks
Best5555: bets $0.74
Make Gains: raises $3.89 to $4.63 and is all-in
Best5555: folds
Uncalled bet ($3.89) returned to Make Gains
Make Gains collected $2.40 from pot
Make Gains: doesn't show hand
*** SUMMARY ***
Total pot $2.50 | Rake $0.10
Board [5d Ah 3h]
Seat 1: donn1987 (button) folded before Flop (didn't bet)
Seat 2: Baksojor (small blind) folded before Flop
Seat 3: Make Gains (big blind) collected ($2.40)
Seat 4: Best5555 folded on the Flop
Seat 5: NoSmokinggg folded before Flop (didn't bet)
Seat 6: nodarik1980 folded before Flop (didn't bet)


*********** # 119 **************
PokerStars Zoom Hand #174048193433:  Hold'em No Limit ($0.02/$0.05) - 2017/08/07 23:28:58 MSK [2017/08/07 16:28:58 ET]
Table 'Donati' 6-max Seat #1 is the button
Seat 1: Baksojor ($15.85 in chips)
Seat 2: MiyagiMaster ($5 in chips)
Seat 3: Jura752 ($2.03 in chips)
Seat 4: Teflonmemory ($5.11 in chips)
Seat 5: tursows ($5.68 in chips)
Seat 6: schmilf ($5.05 in chips)
MiyagiMaster: posts small blind $0.02
Jura752: posts big blind $0.05
*** HOLE CARDS ***
Dealt to Baksojor [2s 7h]
Teflonmemory: raises $0.10 to $0.15
tursows: folds
schmilf: folds
Baksojor: folds
MiyagiMaster: folds
Jura752: raises $0.40 to $0.55
Teflonmemory: calls $0.40
*** FLOP *** [4h Ac Jc]
Jura752: bets $1.48 and is all-in
Teflonmemory: folds
Uncalled bet ($1.48) returned to Jura752
Jura752 collected $1.07 from pot
Jura752: doesn't show hand
*** SUMMARY ***
Total pot $1.12 | Rake $0.05
Board [4h Ac Jc]
Seat 1: Baksojor (button) folded before Flop (didn't bet)
Seat 2: MiyagiMaster (small blind) folded before Flop
Seat 3: Jura752 (big blind) collected ($1.07)
Seat 4: Teflonmemory folded on the Flop
Seat 5: tursows folded before Flop (didn't bet)
Seat 6: schmilf folded before Flop (didn't bet)


*********** # 120 **************
PokerStars Zoom Hand #174048150783:  Hold'em No Limit ($0.02/$0.05) - 2017/08/07 23:28:04 MSK [2017/08/07 16:28:04 ET]
Table 'Donati' 6-max Seat #1 is the button
Seat 1: Anton Tr ($5 in chips)
Seat 2: FINTIFLYSHKI ($7.14 in chips)
Seat 3: Baksojor ($16.35 in chips)
Seat 4: plasencia345 ($7.65 in chips)
Seat 5: logmans ($5.06 in chips)
Seat 6: Conan0024 ($9.97 in chips)
FINTIFLYSHKI: posts small blind $0.02
Baksojor: posts big blind $0.05
*** HOLE CARDS ***
Dealt to Baksojor [Ac Td]
plasencia345: folds
logmans: folds
Conan0024: folds
Anton Tr: folds
FINTIFLYSHKI: raises $0.10 to $0.15
Baksojor: calls $0.10
*** FLOP *** [9d Kd 3d]
FINTIFLYSHKI: bets $0.10
Baksojor: calls $0.10
*** TURN *** [9d Kd 3d] [4c]
FINTIFLYSHKI: checks
Baksojor: bets $0.25
FINTIFLYSHKI: calls $0.25
*** RIVER *** [9d Kd 3d 4c] [6c]
FINTIFLYSHKI: bets $0.35
Baksojor: folds
Uncalled bet ($0.35) returned to FINTIFLYSHKI
FINTIFLYSHKI collected $0.96 from pot
FINTIFLYSHKI: doesn't show hand
*** SUMMARY ***
Total pot $1 | Rake $0.04
Board [9d Kd 3d 4c 6c]
Seat 1: Anton Tr (button) folded before Flop (didn't bet)
Seat 2: FINTIFLYSHKI (small blind) collected ($0.96)
Seat 3: Baksojor (big blind) folded on the River
Seat 4: plasencia345 folded before Flop (didn't bet)
Seat 5: logmans folded before Flop (didn't bet)
Seat 6: Conan0024 folded before Flop (didn't bet)


*********** # 121 **************
PokerStars Zoom Hand #174048140446:  Hold'em No Limit ($0.02/$0.05) - 2017/08/07 23:27:51 MSK [2017/08/07 16:27:51 ET]
Table 'Donati' 6-max Seat #1 is the button
Seat 1: Conan0024 ($7.37 in chips)
Seat 2: hen1337 ($5 in chips)
Seat 3: logmans ($5.11 in chips)
Seat 4: ULTRAST87 ($3.98 in chips)
Seat 5: Baksojor ($16.28 in chips)
Seat 6: Ray1337996 ($4.85 in chips)
hen1337: posts small blind $0.02
logmans: posts big blind $0.05
*** HOLE CARDS ***
Dealt to Baksojor [4c 5c]
ULTRAST87: folds
Baksojor: raises $0.07 to $0.12
Ray1337996: folds
Conan0024: folds
hen1337: folds
logmans: folds
Uncalled bet ($0.07) returned to Baksojor
Baksojor collected $0.12 from pot
Baksojor: doesn't show hand
*** SUMMARY ***
Total pot $0.12 | Rake $0
Seat 1: Conan0024 (button) folded before Flop (didn't bet)
Seat 2: hen1337 (small blind) folded before Flop
Seat 3: logmans (big blind) folded before Flop
Seat 4: ULTRAST87 folded before Flop (didn't bet)
Seat 5: Baksojor collected ($0.12)
Seat 6: Ray1337996 folded before Flop (didn't bet)


*********** # 122 **************
PokerStars Zoom Hand #174048137347:  Hold'em No Limit ($0.02/$0.05) - 2017/08/07 23:27:47 MSK [2017/08/07 16:27:47 ET]
Table 'Donati' 6-max Seat #1 is the button
Seat 1: Chrisse141 ($1.06 in chips)
Seat 2: Cross Damon ($5.81 in chips)
Seat 3: StephBpee ($2.23 in chips)
Seat 4: alin_fn90 ($1.34 in chips)
Seat 5: KCH288 ($5 in chips)
Seat 6: Baksojor ($16.28 in chips)
Cross Damon: posts small blind $0.02
StephBpee: posts big blind $0.05
*** HOLE CARDS ***
Dealt to Baksojor [7d 5s]
alin_fn90: folds
KCH288: raises $0.10 to $0.15
Baksojor: folds
Chrisse141: calls $0.15
Cross Damon: folds
StephBpee: folds
*** FLOP *** [Jd 4h 9d]
KCH288: bets $0.23
Chrisse141: calls $0.23
*** TURN *** [Jd 4h 9d] [Kc]
KCH288: checks
Chrisse141: bets $0.40
KCH288: raises $1.05 to $1.45
Chrisse141: calls $0.28 and is all-in
Uncalled bet ($0.77) returned to KCH288
*** RIVER *** [Jd 4h 9d Kc] [Qs]
*** SHOW DOWN ***
KCH288: shows [Js Ad] (a pair of Jacks)
Chrisse141: shows [9h 8s] (a pair of Nines)
KCH288 collected $2.10 from pot
*** SUMMARY ***
Total pot $2.19 | Rake $0.09
Board [Jd 4h 9d Kc Qs]
Seat 1: Chrisse141 (button) showed [9h 8s] and lost with a pair of Nines
Seat 2: Cross Damon (small blind) folded before Flop
Seat 3: StephBpee (big blind) folded before Flop
Seat 4: alin_fn90 folded before Flop (didn't bet)
Seat 5: KCH288 showed [Js Ad] and won ($2.10) with a pair of Jacks
Seat 6: Baksojor folded before Flop (didn't bet)


*********** # 123 **************
PokerStars Zoom Hand #174048101621:  Hold'em No Limit ($0.02/$0.05) - 2017/08/07 23:27:02 MSK [2017/08/07 16:27:02 ET]
Table 'Donati' 6-max Seat #1 is the button
Seat 1: Utitahte ($4.52 in chips)
Seat 2: wasteman999 ($2.45 in chips)
Seat 3: FINTIFLYSHKI ($7.19 in chips)
Seat 4: Baksojor ($13.99 in chips)
Seat 5: Lina6591 ($8.91 in chips)
Seat 6: Bisi6611 ($6.46 in chips)
wasteman999: posts small blind $0.02
FINTIFLYSHKI: posts big blind $0.05
*** HOLE CARDS ***
Dealt to Baksojor [Kd Qc]
Baksojor: raises $0.07 to $0.12
Lina6591: folds
Bisi6611: folds
Utitahte: folds
wasteman999: raises $0.07 to $0.19
FINTIFLYSHKI: folds
Baksojor: calls $0.07
*** FLOP *** [Kh Qs 9h]
wasteman999: bets $0.15
Baksojor: raises $0.35 to $0.50
wasteman999: raises $0.35 to $0.85
Baksojor: raises $1.58 to $2.43
wasteman999: calls $1.41 and is all-in
Uncalled bet ($0.17) returned to Baksojor
*** TURN *** [Kh Qs 9h] [7c]
*** RIVER *** [Kh Qs 9h 7c] [3s]
*** SHOW DOWN ***
wasteman999: shows [Ac Ad] (a pair of Aces)
Baksojor: shows [Kd Qc] (two pair, Kings and Queens)
Baksojor collected $4.74 from pot
*** SUMMARY ***
Total pot $4.95 | Rake $0.21
Board [Kh Qs 9h 7c 3s]
Seat 1: Utitahte (button) folded before Flop (didn't bet)
Seat 2: wasteman999 (small blind) showed [Ac Ad] and lost with a pair of Aces
Seat 3: FINTIFLYSHKI (big blind) folded before Flop
Seat 4: Baksojor showed [Kd Qc] and won ($4.74) with two pair, Kings and Queens
Seat 5: Lina6591 folded before Flop (didn't bet)
Seat 6: Bisi6611 folded before Flop (didn't bet)


*********** # 124 **************
PokerStars Zoom Hand #174048070747:  Hold'em No Limit ($0.02/$0.05) - 2017/08/07 23:26:23 MSK [2017/08/07 16:26:23 ET]
Table 'Donati' 6-max Seat #1 is the button
Seat 1: LuckyIldar ($10.18 in chips)
Seat 2: Demon31222 ($5.27 in chips)
Seat 3: andrey4ik8 ($2.46 in chips)
Seat 4: dark h0r$e ($5.42 in chips)
Seat 5: V.S.151 ($7.59 in chips)
Seat 6: Baksojor ($14.29 in chips)
Demon31222: posts small blind $0.02
andrey4ik8: posts big blind $0.05
*** HOLE CARDS ***
Dealt to Baksojor [3c 3d]
dark h0r$e: folds
V.S.151: folds
Baksojor: raises $0.07 to $0.12
LuckyIldar: raises $0.18 to $0.30
Demon31222: folds
andrey4ik8: folds
Baksojor: calls $0.18
*** FLOP *** [7s Ah Ks]
Baksojor: checks
LuckyIldar: bets $0.42
Baksojor: folds
Uncalled bet ($0.42) returned to LuckyIldar
LuckyIldar collected $0.64 from pot
LuckyIldar: doesn't show hand
*** SUMMARY ***
Total pot $0.67 | Rake $0.03
Board [7s Ah Ks]
Seat 1: LuckyIldar (button) collected ($0.64)
Seat 2: Demon31222 (small blind) folded before Flop
Seat 3: andrey4ik8 (big blind) folded before Flop
Seat 4: dark h0r$e folded before Flop (didn't bet)
Seat 5: V.S.151 folded before Flop (didn't bet)
Seat 6: Baksojor folded on the Flop


*********** # 125 **************
PokerStars Zoom Hand #174048067655:  Hold'em No Limit ($0.02/$0.05) - 2017/08/07 23:26:19 MSK [2017/08/07 16:26:19 ET]
Table 'Donati' 6-max Seat #1 is the button
Seat 1: gehcastro ($9.72 in chips)
Seat 2: kadafka ($5.18 in chips)
Seat 3: Andr1972 ($5.19 in chips)
Seat 4: kscloud ($5.36 in chips)
Seat 5: Baksojor ($14.29 in chips)
Seat 6: Cross Damon ($5.87 in chips)
kadafka: posts small blind $0.02
Andr1972: posts big blind $0.05
*** HOLE CARDS ***
Dealt to Baksojor [6s Qd]
kscloud: folds
Baksojor: folds
Cross Damon: folds
gehcastro: folds
kadafka: raises $0.05 to $0.10
Andr1972: folds
Uncalled bet ($0.05) returned to kadafka
kadafka collected $0.10 from pot
kadafka: doesn't show hand
*** SUMMARY ***
Total pot $0.10 | Rake $0
Seat 1: gehcastro (button) folded before Flop (didn't bet)
Seat 2: kadafka (small blind) collected ($0.10)
Seat 3: Andr1972 (big blind) folded before Flop
Seat 4: kscloud folded before Flop (didn't bet)
Seat 5: Baksojor folded before Flop (didn't bet)
Seat 6: Cross Damon folded before Flop (didn't bet)


*********** # 126 **************
PokerStars Zoom Hand #174048064460:  Hold'em No Limit ($0.02/$0.05) - 2017/08/07 23:26:15 MSK [2017/08/07 16:26:15 ET]
Table 'Donati' 6-max Seat #1 is the button
Seat 1: tursows ($5.28 in chips)
Seat 2: Baksojor ($14.31 in chips)
Seat 3: Ashlar123 ($7.47 in chips)
Seat 4: xizza ($6.11 in chips)
Seat 5: la biere ($10.94 in chips)
Seat 6: InteRus13 ($9.27 in chips)
Baksojor: posts small blind $0.02
Ashlar123: posts big blind $0.05
*** HOLE CARDS ***
Dealt to Baksojor [7d 2h]
xizza: folds
la biere: folds
InteRus13: folds
tursows: raises $0.07 to $0.12
Baksojor: folds
Ashlar123: raises $0.48 to $0.60
tursows: folds
Uncalled bet ($0.48) returned to Ashlar123
Ashlar123 collected $0.26 from pot
Ashlar123: doesn't show hand
*** SUMMARY ***
Total pot $0.26 | Rake $0
Seat 1: tursows (button) folded before Flop
Seat 2: Baksojor (small blind) folded before Flop
Seat 3: Ashlar123 (big blind) collected ($0.26)
Seat 4: xizza folded before Flop (didn't bet)
Seat 5: la biere folded before Flop (didn't bet)
Seat 6: InteRus13 folded before Flop (didn't bet)


*********** # 127 **************
PokerStars Zoom Hand #174048048581:  Hold'em No Limit ($0.02/$0.05) - 2017/08/07 23:25:55 MSK [2017/08/07 16:25:55 ET]
Table 'Donati' 6-max Seat #1 is the button
Seat 1: Baksojor ($14.41 in chips)
Seat 2: InfideliX ($2.68 in chips)
Seat 3: FINTIFLYSHKI ($7 in chips)
Seat 4: 7800-traek ($2.90 in chips)
Seat 5: PayForSee ($6.34 in chips)
Seat 6: AlexxPoltava ($11.24 in chips)
InfideliX: posts small blind $0.02
FINTIFLYSHKI: posts big blind $0.05
*** HOLE CARDS ***
Dealt to Baksojor [5s 4c]
7800-traek: folds
PayForSee: folds
AlexxPoltava: folds
Baksojor: raises $0.05 to $0.10
InfideliX: raises $0.24 to $0.34
FINTIFLYSHKI: folds
Baksojor: folds
Uncalled bet ($0.24) returned to InfideliX
InfideliX collected $0.25 from pot
InfideliX: doesn't show hand
*** SUMMARY ***
Total pot $0.25 | Rake $0
Seat 1: Baksojor (button) folded before Flop
Seat 2: InfideliX (small blind) collected ($0.25)
Seat 3: FINTIFLYSHKI (big blind) folded before Flop
Seat 4: 7800-traek folded before Flop (didn't bet)
Seat 5: PayForSee folded before Flop (didn't bet)
Seat 6: AlexxPoltava folded before Flop (didn't bet)


*********** # 128 **************
PokerStars Zoom Hand #174048021805:  Hold'em No Limit ($0.02/$0.05) - 2017/08/07 23:25:25 MSK [2017/08/07 16:25:25 ET]
Table 'Donati' 6-max Seat #1 is the button
Seat 1: opg7 ($5.12 in chips)
Seat 2: -HAAwaiii- ($2.96 in chips)
Seat 3: Baksojor ($14.56 in chips)
Seat 4: Oscar__62176 ($5.11 in chips)
Seat 5: dark h0r$e ($5.44 in chips)
Seat 6: AlberTSifon ($5.14 in chips)
-HAAwaiii-: posts small blind $0.02
Baksojor: posts big blind $0.05
*** HOLE CARDS ***
Dealt to Baksojor [3c 3h]
Oscar__62176: raises $0.10 to $0.15
dark h0r$e: folds
AlberTSifon: folds
opg7: folds
-HAAwaiii-: folds
Baksojor: calls $0.10
*** FLOP *** [Tc Qs 6c]
Baksojor: checks
Oscar__62176: checks
*** TURN *** [Tc Qs 6c] [4s]
Baksojor: checks
Oscar__62176: bets $0.16
Baksojor: folds
Uncalled bet ($0.16) returned to Oscar__62176
Oscar__62176 collected $0.31 from pot
Oscar__62176: doesn't show hand
*** SUMMARY ***
Total pot $0.32 | Rake $0.01
Board [Tc Qs 6c 4s]
Seat 1: opg7 (button) folded before Flop (didn't bet)
Seat 2: -HAAwaiii- (small blind) folded before Flop
Seat 3: Baksojor (big blind) folded on the Turn
Seat 4: Oscar__62176 collected ($0.31)
Seat 5: dark h0r$e folded before Flop (didn't bet)
Seat 6: AlberTSifon folded before Flop (didn't bet)


*********** # 129 **************
PokerStars Zoom Hand #174048018706:  Hold'em No Limit ($0.02/$0.05) - 2017/08/07 23:25:21 MSK [2017/08/07 16:25:21 ET]
Table 'Donati' 6-max Seat #1 is the button
Seat 1: kscloud ($4.30 in chips)
Seat 2: shantaf91 ($8.41 in chips)
Seat 3: dark h0r$e ($5 in chips)
Seat 4: Baksojor ($14.56 in chips)
Seat 5: MSKLucky007 ($5.03 in chips)
Seat 6: nordwolf27 ($6.43 in chips)
shantaf91: posts small blind $0.02
dark h0r$e: posts big blind $0.05
*** HOLE CARDS ***
Dealt to Baksojor [Ts Kh]
Baksojor: folds
MSKLucky007: folds
nordwolf27: folds
kscloud: folds
shantaf91: raises $0.10 to $0.15
dark h0r$e: calls $0.10
*** FLOP *** [4d 5s 7c]
shantaf91: checks
dark h0r$e: bets $0.15
shantaf91: calls $0.15
*** TURN *** [4d 5s 7c] [5c]
shantaf91: checks
dark h0r$e: bets $0.29
shantaf91: calls $0.29
*** RIVER *** [4d 5s 7c 5c] [6c]
shantaf91: checks
dark h0r$e: checks
*** SHOW DOWN ***
shantaf91: shows [Jc Ac] (a flush, Ace high)
dark h0r$e: mucks hand
shantaf91 collected $1.13 from pot
*** SUMMARY ***
Total pot $1.18 | Rake $0.05
Board [4d 5s 7c 5c 6c]
Seat 1: kscloud (button) folded before Flop (didn't bet)
Seat 2: shantaf91 (small blind) showed [Jc Ac] and won ($1.13) with a flush, Ace high
Seat 3: dark h0r$e (big blind) mucked [Jd Js]
Seat 4: Baksojor folded before Flop (didn't bet)
Seat 5: MSKLucky007 folded before Flop (didn't bet)
Seat 6: nordwolf27 folded before Flop (didn't bet)


*********** # 130 **************
PokerStars Zoom Hand #174048014023:  Hold'em No Limit ($0.02/$0.05) - 2017/08/07 23:25:15 MSK [2017/08/07 16:25:15 ET]
Table 'Donati' 6-max Seat #1 is the button
Seat 1: Andr1972 ($5.19 in chips)
Seat 2: Baksojor ($14.58 in chips)
Seat 3: Tboy_4A ($19.90 in chips)
Seat 4: guilhermev85 ($5.43 in chips)
Seat 5: nordwolf27 ($6.43 in chips)
Seat 6: Girigal ($6.09 in chips)
Baksojor: posts small blind $0.02
Tboy_4A: posts big blind $0.05
*** HOLE CARDS ***
Dealt to Baksojor [9d 7c]
guilhermev85: folds
nordwolf27: folds
Girigal: folds
Andr1972: folds
Baksojor: folds
Uncalled bet ($0.03) returned to Tboy_4A
Tboy_4A collected $0.04 from pot
Tboy_4A: doesn't show hand
*** SUMMARY ***
Total pot $0.04 | Rake $0
Seat 1: Andr1972 (button) folded before Flop (didn't bet)
Seat 2: Baksojor (small blind) folded before Flop
Seat 3: Tboy_4A (big blind) collected ($0.04)
Seat 4: guilhermev85 folded before Flop (didn't bet)
Seat 5: nordwolf27 folded before Flop (didn't bet)
Seat 6: Girigal folded before Flop (didn't bet)


*********** # 131 **************
PokerStars Zoom Hand #174048004677:  Hold'em No Limit ($0.02/$0.05) - 2017/08/07 23:25:03 MSK [2017/08/07 16:25:03 ET]
Table 'Donati' 6-max Seat #1 is the button
Seat 1: Mikaeus ($8.72 in chips)
Seat 2: Aleks Ryder ($41.31 in chips)
Seat 3: Baksojor ($14.63 in chips)
Seat 4: V.S.151 ($10.79 in chips)
Seat 5: Wally Diddy ($5.61 in chips)
Seat 6: gambler4f ($5.16 in chips)
Aleks Ryder: posts small blind $0.02
Baksojor: posts big blind $0.05
*** HOLE CARDS ***
Dealt to Baksojor [7c 5h]
V.S.151: folds
Wally Diddy: folds
gambler4f: raises $0.07 to $0.12
Mikaeus: folds
Aleks Ryder: folds
Baksojor: folds
Uncalled bet ($0.07) returned to gambler4f
gambler4f collected $0.12 from pot
gambler4f: doesn't show hand
*** SUMMARY ***
Total pot $0.12 | Rake $0
Seat 1: Mikaeus (button) folded before Flop (didn't bet)
Seat 2: Aleks Ryder (small blind) folded before Flop
Seat 3: Baksojor (big blind) folded before Flop
Seat 4: V.S.151 folded before Flop (didn't bet)
Seat 5: Wally Diddy folded before Flop (didn't bet)
Seat 6: gambler4f collected ($0.12)


*********** # 132 **************
PokerStars Zoom Hand #174047946435:  Hold'em No Limit ($0.02/$0.05) - 2017/08/07 23:23:49 MSK [2017/08/07 16:23:49 ET]
Table 'Donati' 6-max Seat #1 is the button
Seat 1: Baksojor ($13.65 in chips)
Seat 2: YmanB ($2.77 in chips)
Seat 3: igor007 :282 ($1.23 in chips)
Seat 4: baozinq1 ($5.54 in chips)
Seat 5: BigBoyStakes ($8.80 in chips)
Seat 6: merhba ($14.67 in chips)
YmanB: posts small blind $0.02
igor007 :282: posts big blind $0.05
*** HOLE CARDS ***
Dealt to Baksojor [Kd Jh]
baozinq1: folds
BigBoyStakes: folds
merhba: raises $0.05 to $0.10
Baksojor: raises $0.25 to $0.35
YmanB: folds
igor007 :282: folds
merhba: calls $0.25
*** FLOP *** [9h Td 4c]
merhba: checks
Baksojor: checks
*** TURN *** [9h Td 4c] [9c]
merhba: bets $0.20
Baksojor: calls $0.20
*** RIVER *** [9h Td 4c 9c] [Qh]
merhba: bets $0.45
Baksojor: raises $1.20 to $1.65
merhba: folds
Uncalled bet ($1.20) returned to Baksojor
Baksojor collected $1.98 from pot
Baksojor: doesn't show hand
*** SUMMARY ***
Total pot $2.07 | Rake $0.09
Board [9h Td 4c 9c Qh]
Seat 1: Baksojor (button) collected ($1.98)
Seat 2: YmanB (small blind) folded before Flop
Seat 3: igor007 :282 (big blind) folded before Flop
Seat 4: baozinq1 folded before Flop (didn't bet)
Seat 5: BigBoyStakes folded before Flop (didn't bet)
Seat 6: merhba folded on the River


*********** # 133 **************
PokerStars Zoom Hand #174047943280:  Hold'em No Limit ($0.02/$0.05) - 2017/08/07 23:23:45 MSK [2017/08/07 16:23:45 ET]
Table 'Donati' 6-max Seat #1 is the button
Seat 1: Taron-gao ($4.12 in chips)
Seat 2: LuckyIldar ($20.97 in chips)
Seat 3: MSKLucky007 ($5.15 in chips)
Seat 4: Cross Damon ($5.53 in chips)
Seat 5: Frodu46 ($5.44 in chips)
Seat 6: Baksojor ($13.65 in chips)
LuckyIldar: posts small blind $0.02
MSKLucky007: posts big blind $0.05
*** HOLE CARDS ***
Dealt to Baksojor [4c 3s]
Cross Damon: raises $0.07 to $0.12
Frodu46: folds
Baksojor: folds
Taron-gao: folds
LuckyIldar: folds
MSKLucky007: folds
Uncalled bet ($0.07) returned to Cross Damon
Cross Damon collected $0.12 from pot
Cross Damon: doesn't show hand
*** SUMMARY ***
Total pot $0.12 | Rake $0
Seat 1: Taron-gao (button) folded before Flop (didn't bet)
Seat 2: LuckyIldar (small blind) folded before Flop
Seat 3: MSKLucky007 (big blind) folded before Flop
Seat 4: Cross Damon collected ($0.12)
Seat 5: Frodu46 folded before Flop (didn't bet)
Seat 6: Baksojor folded before Flop (didn't bet)


*********** # 134 **************
PokerStars Zoom Hand #174047940153:  Hold'em No Limit ($0.02/$0.05) - 2017/08/07 23:23:41 MSK [2017/08/07 16:23:41 ET]
Table 'Donati' 6-max Seat #1 is the button
Seat 1: mmegan92 ($5.65 in chips)
Seat 2: Sathar123 ($10.39 in chips)
Seat 3: antoxa oz ($17.24 in chips)
Seat 4: Swing1025 ($8.41 in chips)
Seat 5: Baksojor ($13.65 in chips)
Seat 6: xerrorPL ($5.07 in chips)
Sathar123: posts small blind $0.02
antoxa oz: posts big blind $0.05
*** HOLE CARDS ***
Dealt to Baksojor [8h Ad]
Swing1025: folds
Baksojor: folds
xerrorPL: folds
mmegan92: folds
Sathar123: raises $0.10 to $0.15
antoxa oz: folds
Uncalled bet ($0.10) returned to Sathar123
Sathar123 collected $0.10 from pot
Sathar123: doesn't show hand
*** SUMMARY ***
Total pot $0.10 | Rake $0
Seat 1: mmegan92 (button) folded before Flop (didn't bet)
Seat 2: Sathar123 (small blind) collected ($0.10)
Seat 3: antoxa oz (big blind) folded before Flop
Seat 4: Swing1025 folded before Flop (didn't bet)
Seat 5: Baksojor folded before Flop (didn't bet)
Seat 6: xerrorPL folded before Flop (didn't bet)


*********** # 135 **************
PokerStars Zoom Hand #174047883253:  Hold'em No Limit ($0.02/$0.05) - 2017/08/07 23:22:29 MSK [2017/08/07 16:22:29 ET]
Table 'Donati' 6-max Seat #1 is the button
Seat 1: gambler4f ($5.07 in chips)
Seat 2: AlberTSifon ($5.07 in chips)
Seat 3: mrGold443 ($9.51 in chips)
Seat 4: Baksojor ($8.87 in chips)
Seat 5: ElbowsKnees ($7.21 in chips)
Seat 6: rolwan ($5.14 in chips)
AlberTSifon: posts small blind $0.02
mrGold443: posts big blind $0.05
*** HOLE CARDS ***
Dealt to Baksojor [2s 2c]
Baksojor: raises $0.07 to $0.12
ElbowsKnees: folds
rolwan: raises $0.31 to $0.43
gambler4f: folds
AlberTSifon: folds
mrGold443: folds
Baksojor: calls $0.31
*** FLOP *** [2h Jc 2d]
Baksojor: checks
rolwan: bets $0.89
Baksojor: calls $0.89
*** TURN *** [2h Jc 2d] [5h]
Baksojor: checks
rolwan: bets $1.50
Baksojor: raises $4.20 to $5.70
rolwan: calls $2.32 and is all-in
Uncalled bet ($1.88) returned to Baksojor
*** RIVER *** [2h Jc 2d 5h] [4d]
*** SHOW DOWN ***
Baksojor: shows [2s 2c] (four of a kind, Deuces)
rolwan: shows [Ah Jh] (two pair, Jacks and Deuces)
Baksojor collected $9.92 from pot
*** SUMMARY ***
Total pot $10.35 | Rake $0.43
Board [2h Jc 2d 5h 4d]
Seat 1: gambler4f (button) folded before Flop (didn't bet)
Seat 2: AlberTSifon (small blind) folded before Flop
Seat 3: mrGold443 (big blind) folded before Flop
Seat 4: Baksojor showed [2s 2c] and won ($9.92) with four of a kind, Deuces
Seat 5: ElbowsKnees folded before Flop (didn't bet)
Seat 6: rolwan showed [Ah Jh] and lost with two pair, Jacks and Deuces


*********** # 136 **************
PokerStars Zoom Hand #174047880116:  Hold'em No Limit ($0.02/$0.05) - 2017/08/07 23:22:25 MSK [2017/08/07 16:22:25 ET]
Table 'Donati' 6-max Seat #1 is the button
Seat 1: Scar_spb ($5 in chips)
Seat 2: Demon31222 ($5 in chips)
Seat 3: Girigal ($5.37 in chips)
Seat 4: dimon36krut ($5.27 in chips)
Seat 5: Ramona1210 ($1.77 in chips)
Seat 6: Baksojor ($8.87 in chips)
Demon31222: posts small blind $0.02
Girigal: posts big blind $0.05
*** HOLE CARDS ***
Dealt to Baksojor [Jh 2c]
dimon36krut: folds
Ramona1210: raises $0.05 to $0.10
Baksojor: folds
Scar_spb: folds
Demon31222: folds
Girigal: folds
Uncalled bet ($0.05) returned to Ramona1210
Ramona1210 collected $0.12 from pot
Ramona1210: doesn't show hand
*** SUMMARY ***
Total pot $0.12 | Rake $0
Seat 1: Scar_spb (button) folded before Flop (didn't bet)
Seat 2: Demon31222 (small blind) folded before Flop
Seat 3: Girigal (big blind) folded before Flop
Seat 4: dimon36krut folded before Flop (didn't bet)
Seat 5: Ramona1210 collected ($0.12)
Seat 6: Baksojor folded before Flop (didn't bet)


*********** # 137 **************
PokerStars Zoom Hand #174047856538:  Hold'em No Limit ($0.02/$0.05) - 2017/08/07 23:21:55 MSK [2017/08/07 16:21:55 ET]
Table 'Donati' 6-max Seat #1 is the button
Seat 1: Baksojor ($9.09 in chips)
Seat 2: PayForSee ($6.72 in chips)
Seat 3: 999Monstr999 ($9.44 in chips)
Seat 4: Piensxl ($5 in chips)
Seat 5: Hottedxd ($23.28 in chips)
Seat 6: fam007007 ($5.07 in chips)
PayForSee: posts small blind $0.02
999Monstr999: posts big blind $0.05
*** HOLE CARDS ***
Dealt to Baksojor [Tc 3c]
Piensxl: folds
Hottedxd: folds
fam007007: folds
Baksojor: raises $0.05 to $0.10
PayForSee: folds
999Monstr999: calls $0.05
*** FLOP *** [Td 5c Kd]
999Monstr999: checks
Baksojor: bets $0.12
999Monstr999: raises $0.38 to $0.50
Baksojor: folds
Uncalled bet ($0.38) returned to 999Monstr999
999Monstr999 collected $0.44 from pot
999Monstr999: doesn't show hand
*** SUMMARY ***
Total pot $0.46 | Rake $0.02
Board [Td 5c Kd]
Seat 1: Baksojor (button) folded on the Flop
Seat 2: PayForSee (small blind) folded before Flop
Seat 3: 999Monstr999 (big blind) collected ($0.44)
Seat 4: Piensxl folded before Flop (didn't bet)
Seat 5: Hottedxd folded before Flop (didn't bet)
Seat 6: fam007007 folded before Flop (didn't bet)


*********** # 138 **************
PokerStars Zoom Hand #174047854160:  Hold'em No Limit ($0.02/$0.05) - 2017/08/07 23:21:52 MSK [2017/08/07 16:21:52 ET]
Table 'Donati' 6-max Seat #1 is the button
Seat 1: SH3MYAK ($4.29 in chips)
Seat 2: Baksojor ($9.11 in chips)
Seat 3: Swing1025 ($8.48 in chips)
Seat 4: SNAGATA22 ($7.59 in chips)
Seat 5: xizza ($5 in chips)
Seat 6: igorovs ($4.25 in chips)
Baksojor: posts small blind $0.02
Swing1025: posts big blind $0.05
*** HOLE CARDS ***
Dealt to Baksojor [6d 8s]
SNAGATA22: calls $0.05
xizza: folds
igorovs: folds
SH3MYAK: folds
Baksojor: folds
Swing1025: checks
*** FLOP *** [Qh 7s 3c]
Swing1025: checks
SNAGATA22: checks
*** TURN *** [Qh 7s 3c] [9s]
Swing1025: checks
SNAGATA22: checks
*** RIVER *** [Qh 7s 3c 9s] [Kd]
Swing1025: checks
SNAGATA22: checks
*** SHOW DOWN ***
Swing1025: shows [Th 5s] (high card King)
SNAGATA22: shows [5d 5c] (a pair of Fives)
SNAGATA22 collected $0.12 from pot
*** SUMMARY ***
Total pot $0.12 | Rake $0
Board [Qh 7s 3c 9s Kd]
Seat 1: SH3MYAK (button) folded before Flop (didn't bet)
Seat 2: Baksojor (small blind) folded before Flop
Seat 3: Swing1025 (big blind) showed [Th 5s] and lost with high card King
Seat 4: SNAGATA22 showed [5d 5c] and won ($0.12) with a pair of Fives
Seat 5: xizza folded before Flop (didn't bet)
Seat 6: igorovs folded before Flop (didn't bet)


*********** # 139 **************
PokerStars Zoom Hand #174047851073:  Hold'em No Limit ($0.02/$0.05) - 2017/08/07 23:21:48 MSK [2017/08/07 16:21:48 ET]
Table 'Donati' 6-max Seat #1 is the button
Seat 1: Arkadiy651 ($35.09 in chips)
Seat 2: KCH288 ($21.62 in chips)
Seat 3: demetrism ($4.20 in chips)
Seat 4: pokerfan3999 ($5.16 in chips)
Seat 5: Baksojor ($9.11 in chips)
Seat 6: mmegan92 ($5.84 in chips)
KCH288: posts small blind $0.02
demetrism: posts big blind $0.05
*** HOLE CARDS ***
Dealt to Baksojor [8c Js]
pokerfan3999: folds
Baksojor: folds
mmegan92: folds
Arkadiy651: folds
KCH288: folds
Uncalled bet ($0.03) returned to demetrism
demetrism collected $0.04 from pot
demetrism: doesn't show hand
*** SUMMARY ***
Total pot $0.04 | Rake $0
Seat 1: Arkadiy651 (button) folded before Flop (didn't bet)
Seat 2: KCH288 (small blind) folded before Flop
Seat 3: demetrism (big blind) collected ($0.04)
Seat 4: pokerfan3999 folded before Flop (didn't bet)
Seat 5: Baksojor folded before Flop (didn't bet)
Seat 6: mmegan92 folded before Flop (didn't bet)


*********** # 140 **************
PokerStars Zoom Hand #174047825726:  Hold'em No Limit ($0.02/$0.05) - 2017/08/07 23:21:16 MSK [2017/08/07 16:21:16 ET]
Table 'Donati' 6-max Seat #1 is the button
Seat 1: dark h0r$e ($5 in chips)
Seat 2: xizza ($5 in chips)
Seat 3: antoxa oz ($14.24 in chips)
Seat 4: Baksojor ($9.23 in chips)
Seat 5: and_67rus ($3.49 in chips)
Seat 6: Wondydack ($5.17 in chips)
xizza: posts small blind $0.02
antoxa oz: posts big blind $0.05
*** HOLE CARDS ***
Dealt to Baksojor [3c 3s]
Baksojor: raises $0.07 to $0.12
and_67rus: calls $0.12
Wondydack: folds
dark h0r$e: folds
xizza: folds
antoxa oz: folds
*** FLOP *** [Ks 4h Jc]
Baksojor: checks
and_67rus: checks
*** TURN *** [Ks 4h Jc] [7s]
Baksojor: checks
and_67rus: checks
*** RIVER *** [Ks 4h Jc 7s] [Js]
Baksojor: checks
and_67rus: checks
*** SHOW DOWN ***
Baksojor: shows [3c 3s] (two pair, Jacks and Threes)
and_67rus: shows [9d 9s] (two pair, Jacks and Nines)
and_67rus collected $0.30 from pot
*** SUMMARY ***
Total pot $0.31 | Rake $0.01
Board [Ks 4h Jc 7s Js]
Seat 1: dark h0r$e (button) folded before Flop (didn't bet)
Seat 2: xizza (small blind) folded before Flop
Seat 3: antoxa oz (big blind) folded before Flop
Seat 4: Baksojor showed [3c 3s] and lost with two pair, Jacks and Threes
Seat 5: and_67rus showed [9d 9s] and won ($0.30) with two pair, Jacks and Nines
Seat 6: Wondydack folded before Flop (didn't bet)


*********** # 141 **************
PokerStars Zoom Hand #174047808075:  Hold'em No Limit ($0.02/$0.05) - 2017/08/07 23:20:54 MSK [2017/08/07 16:20:54 ET]
Table 'Donati' 6-max Seat #1 is the button
Seat 1: Halaa16 ($23.11 in chips)
Seat 2: Artili4 ($6.62 in chips)
Seat 3: Baksojor ($9.28 in chips)
Seat 4: nodarik1980 ($5.71 in chips)
Seat 5: AKKbank ($5.49 in chips)
Seat 6: Demon31222 ($5.16 in chips)
Artili4: posts small blind $0.02
Baksojor: posts big blind $0.05
*** HOLE CARDS ***
Dealt to Baksojor [9h 7d]
nodarik1980: raises $0.10 to $0.15
AKKbank: folds
Demon31222: folds
Halaa16: folds
Artili4: folds
Baksojor: folds
Uncalled bet ($0.10) returned to nodarik1980
nodarik1980 collected $0.12 from pot
nodarik1980: doesn't show hand
*** SUMMARY ***
Total pot $0.12 | Rake $0
Seat 1: Halaa16 (button) folded before Flop (didn't bet)
Seat 2: Artili4 (small blind) folded before Flop
Seat 3: Baksojor (big blind) folded before Flop
Seat 4: nodarik1980 collected ($0.12)
Seat 5: AKKbank folded before Flop (didn't bet)
Seat 6: Demon31222 folded before Flop (didn't bet)


*********** # 142 **************
PokerStars Zoom Hand #174047801613:  Hold'em No Limit ($0.02/$0.05) - 2017/08/07 23:20:46 MSK [2017/08/07 16:20:46 ET]
Table 'Donati' 6-max Seat #1 is the button
Seat 1: Andrei198509 ($5.14 in chips)
Seat 2: b72rus ($7.58 in chips)
Seat 3: oveandout ($3.78 in chips)
Seat 4: Private_Al ($2.76 in chips)
Seat 5: AlexxPoltava ($9.71 in chips)
Seat 6: Baksojor ($9.28 in chips)
b72rus: posts small blind $0.02
oveandout: posts big blind $0.05
*** HOLE CARDS ***
Dealt to Baksojor [3c Qh]
Private_Al: folds
AlexxPoltava: folds
Baksojor: folds
Andrei198509: folds
b72rus: raises $0.10 to $0.15
oveandout: folds
Uncalled bet ($0.10) returned to b72rus
b72rus collected $0.10 from pot
b72rus: doesn't show hand
*** SUMMARY ***
Total pot $0.10 | Rake $0
Seat 1: Andrei198509 (button) folded before Flop (didn't bet)
Seat 2: b72rus (small blind) collected ($0.10)
Seat 3: oveandout (big blind) folded before Flop
Seat 4: Private_Al folded before Flop (didn't bet)
Seat 5: AlexxPoltava folded before Flop (didn't bet)
Seat 6: Baksojor folded before Flop (didn't bet)


*********** # 143 **************
PokerStars Zoom Hand #174047754874:  Hold'em No Limit ($0.02/$0.05) - 2017/08/07 23:19:47 MSK [2017/08/07 16:19:47 ET]
Table 'Donati' 6-max Seat #1 is the button
Seat 1: ser111375 ($5 in chips)
Seat 2: Baksojor ($8.52 in chips)
Seat 3: schmilf ($5.27 in chips)
Seat 4: homygotya ($21.70 in chips)
Seat 5: glnzz ($6.11 in chips)
Seat 6: PayForSee ($6.59 in chips)
Baksojor: posts small blind $0.02
schmilf: posts big blind $0.05
*** HOLE CARDS ***
Dealt to Baksojor [Qh Js]
homygotya: folds
glnzz: folds
PayForSee: folds
ser111375: folds
Baksojor: raises $0.10 to $0.15
schmilf: calls $0.10
*** FLOP *** [9c Tc Kh]
Baksojor: bets $0.19
schmilf: calls $0.19
*** TURN *** [9c Tc Kh] [Ts]
Baksojor: bets $0.49
schmilf: calls $0.49
*** RIVER *** [9c Tc Kh Ts] [2c]
Baksojor: checks
schmilf: checks
*** SHOW DOWN ***
Baksojor: shows [Qh Js] (a straight, Nine to King)
schmilf: mucks hand
Baksojor collected $1.59 from pot
*** SUMMARY ***
Total pot $1.66 | Rake $0.07
Board [9c Tc Kh Ts 2c]
Seat 1: ser111375 (button) folded before Flop (didn't bet)
Seat 2: Baksojor (small blind) showed [Qh Js] and won ($1.59) with a straight, Nine to King
Seat 3: schmilf (big blind) mucked [6d Kd]
Seat 4: homygotya folded before Flop (didn't bet)
Seat 5: glnzz folded before Flop (didn't bet)
Seat 6: PayForSee folded before Flop (didn't bet)


*********** # 144 **************
PokerStars Zoom Hand #174047751731:  Hold'em No Limit ($0.02/$0.05) - 2017/08/07 23:19:43 MSK [2017/08/07 16:19:43 ET]
Table 'Donati' 6-max Seat #1 is the button
Seat 1: Thedude9212 ($4.66 in chips)
Seat 2: dimon36krut ($5 in chips)
Seat 3: Badger4515 ($5.36 in chips)
Seat 4: Baksojor ($8.52 in chips)
Seat 5: Gederts ($3.05 in chips)
Seat 6: adambuddy ($2.08 in chips)
dimon36krut: posts small blind $0.02
Badger4515: posts big blind $0.05
*** HOLE CARDS ***
Dealt to Baksojor [7c Kc]
Baksojor: folds
Gederts: raises $0.12 to $0.17
adambuddy: folds
Thedude9212: folds
dimon36krut: folds
Badger4515: folds
Uncalled bet ($0.12) returned to Gederts
Gederts collected $0.12 from pot
Gederts: doesn't show hand
*** SUMMARY ***
Total pot $0.12 | Rake $0
Seat 1: Thedude9212 (button) folded before Flop (didn't bet)
Seat 2: dimon36krut (small blind) folded before Flop
Seat 3: Badger4515 (big blind) folded before Flop
Seat 4: Baksojor folded before Flop (didn't bet)
Seat 5: Gederts collected ($0.12)
Seat 6: adambuddy folded before Flop (didn't bet)


*********** # 145 **************
PokerStars Zoom Hand #174047746078:  Hold'em No Limit ($0.02/$0.05) - 2017/08/07 23:19:36 MSK [2017/08/07 16:19:36 ET]
Table 'Donati' 6-max Seat #1 is the button
Seat 1: chraeder ($3.55 in chips)
Seat 2: IVE244 ($7.35 in chips)
Seat 3: Baksojor ($8.57 in chips)
Seat 4: hellhippo ($5.04 in chips)
Seat 5: L.I.N.1989 ($5 in chips)
Seat 6: kingme698 ($5.52 in chips)
IVE244: posts small blind $0.02
Baksojor: posts big blind $0.05
*** HOLE CARDS ***
Dealt to Baksojor [2s Kd]
hellhippo: raises $0.10 to $0.15
L.I.N.1989: folds
kingme698: folds
chraeder: folds
IVE244: folds
Baksojor: folds
Uncalled bet ($0.10) returned to hellhippo
hellhippo collected $0.12 from pot
hellhippo: doesn't show hand
*** SUMMARY ***
Total pot $0.12 | Rake $0
Seat 1: chraeder (button) folded before Flop (didn't bet)
Seat 2: IVE244 (small blind) folded before Flop
Seat 3: Baksojor (big blind) folded before Flop
Seat 4: hellhippo collected ($0.12)
Seat 5: L.I.N.1989 folded before Flop (didn't bet)
Seat 6: kingme698 folded before Flop (didn't bet)


*********** # 146 **************
PokerStars Zoom Hand #174047736514:  Hold'em No Limit ($0.02/$0.05) - 2017/08/07 23:19:24 MSK [2017/08/07 16:19:24 ET]
Table 'Donati' 6-max Seat #1 is the button
Seat 1: Baksojor ($8.57 in chips)
Seat 2: Dasha_1989 ($5 in chips)
Seat 3: 500Ang ($7.26 in chips)
Seat 4: and_67rus ($4.82 in chips)
Seat 5: chraeder ($3.55 in chips)
Seat 6: Kolbert31 ($3.07 in chips)
Dasha_1989: posts small blind $0.02
500Ang: posts big blind $0.05
*** HOLE CARDS ***
Dealt to Baksojor [9c 2c]
and_67rus: folds
chraeder: folds
Kolbert31: calls $0.05
Baksojor: folds
Dasha_1989: calls $0.03
500Ang: checks
*** FLOP *** [9h Qd Th]
Dasha_1989: bets $0.12
500Ang: folds
Kolbert31: calls $0.12
*** TURN *** [9h Qd Th] [Kh]
Dasha_1989: checks
Kolbert31: bets $0.15
Dasha_1989: folds
Uncalled bet ($0.15) returned to Kolbert31
Kolbert31 collected $0.37 from pot
Kolbert31: doesn't show hand
*** SUMMARY ***
Total pot $0.39 | Rake $0.02
Board [9h Qd Th Kh]
Seat 1: Baksojor (button) folded before Flop (didn't bet)
Seat 2: Dasha_1989 (small blind) folded on the Turn
Seat 3: 500Ang (big blind) folded on the Flop
Seat 4: and_67rus folded before Flop (didn't bet)
Seat 5: chraeder folded before Flop (didn't bet)
Seat 6: Kolbert31 collected ($0.37)


*********** # 147 **************
PokerStars Zoom Hand #174047733255:  Hold'em No Limit ($0.02/$0.05) - 2017/08/07 23:19:20 MSK [2017/08/07 16:19:20 ET]
Table 'Donati' 6-max Seat #1 is the button
Seat 1: kuzima_ge ($5.93 in chips)
Seat 2: ketkulol ($4.04 in chips)
Seat 3: hen1337 ($5.05 in chips)
Seat 4: KCH288 ($5.53 in chips)
Seat 5: Baksojor ($8.57 in chips)
Seat 6: corny111 ($3.59 in chips)
ketkulol: posts small blind $0.02
hen1337: posts big blind $0.05
*** HOLE CARDS ***
Dealt to Baksojor [2d 5h]
KCH288: folds
Baksojor: folds
corny111: folds
kuzima_ge: folds
ketkulol: raises $0.07 to $0.12
hen1337: folds
Uncalled bet ($0.07) returned to ketkulol
ketkulol collected $0.10 from pot
ketkulol: doesn't show hand
*** SUMMARY ***
Total pot $0.10 | Rake $0
Seat 1: kuzima_ge (button) folded before Flop (didn't bet)
Seat 2: ketkulol (small blind) collected ($0.10)
Seat 3: hen1337 (big blind) folded before Flop
Seat 4: KCH288 folded before Flop (didn't bet)
Seat 5: Baksojor folded before Flop (didn't bet)
Seat 6: corny111 folded before Flop (didn't bet)


*********** # 148 **************
PokerStars Zoom Hand #174047729311:  Hold'em No Limit ($0.02/$0.05) - 2017/08/07 23:19:15 MSK [2017/08/07 16:19:15 ET]
Table 'Donati' 6-max Seat #1 is the button
Seat 1: BigBoyStakes ($14.70 in chips)
Seat 2: Fox-trouble ($5.18 in chips)
Seat 3: Cross Damon ($5 in chips)
Seat 4: Baksojor ($8.57 in chips)
Seat 5: pawn811 ($16.16 in chips)
Seat 6: gl1oblastr ($5.41 in chips)
Fox-trouble: posts small blind $0.02
Cross Damon: posts big blind $0.05
*** HOLE CARDS ***
Dealt to Baksojor [8d Ad]
Baksojor: folds
pawn811: folds
gl1oblastr: folds
BigBoyStakes: folds
Fox-trouble: folds
Uncalled bet ($0.03) returned to Cross Damon
Cross Damon collected $0.04 from pot
Cross Damon: doesn't show hand
*** SUMMARY ***
Total pot $0.04 | Rake $0
Seat 1: BigBoyStakes (button) folded before Flop (didn't bet)
Seat 2: Fox-trouble (small blind) folded before Flop
Seat 3: Cross Damon (big blind) collected ($0.04)
Seat 4: Baksojor folded before Flop (didn't bet)
Seat 5: pawn811 folded before Flop (didn't bet)
Seat 6: gl1oblastr folded before Flop (didn't bet)


*********** # 149 **************
PokerStars Zoom Hand #174047726078:  Hold'em No Limit ($0.02/$0.05) - 2017/08/07 23:19:11 MSK [2017/08/07 16:19:11 ET]
Table 'Donati' 6-max Seat #1 is the button
Seat 1: hen1337 ($5 in chips)
Seat 2: winkelstraat ($5.09 in chips)
Seat 3: DrDreKid ($5.28 in chips)
Seat 4: Utitahte ($2.91 in chips)
Seat 5: Baksojor ($8.57 in chips)
Seat 6: Andrei198509 ($5.46 in chips)
winkelstraat: posts small blind $0.02
DrDreKid: posts big blind $0.05
*** HOLE CARDS ***
Dealt to Baksojor [6s Ks]
Utitahte: raises $0.05 to $0.10
Baksojor: folds
Andrei198509: folds
hen1337: calls $0.10
winkelstraat: calls $0.08
DrDreKid: folds
*** FLOP *** [Ah 7c 9c]
winkelstraat: checks
Utitahte: bets $0.17
hen1337: folds
winkelstraat: folds
Uncalled bet ($0.17) returned to Utitahte
Utitahte collected $0.34 from pot
Utitahte: doesn't show hand
*** SUMMARY ***
Total pot $0.35 | Rake $0.01
Board [Ah 7c 9c]
Seat 1: hen1337 (button) folded on the Flop
Seat 2: winkelstraat (small blind) folded on the Flop
Seat 3: DrDreKid (big blind) folded before Flop
Seat 4: Utitahte collected ($0.34)
Seat 5: Baksojor folded before Flop (didn't bet)
Seat 6: Andrei198509 folded before Flop (didn't bet)


*********** # 150 **************
PokerStars Zoom Hand #174047722908:  Hold'em No Limit ($0.02/$0.05) - 2017/08/07 23:19:07 MSK [2017/08/07 16:19:07 ET]
Table 'Donati' 6-max Seat #1 is the button
Seat 1: qk rodriguez ($12.67 in chips)
Seat 2: MiyagiMaster ($5 in chips)
Seat 3: Saf-Margo89 ($3.26 in chips)
Seat 4: monetyche ($10.07 in chips)
Seat 5: Demo666er ($17.40 in chips)
Seat 6: Baksojor ($8.57 in chips)
MiyagiMaster: posts small blind $0.02
Saf-Margo89: posts big blind $0.05
*** HOLE CARDS ***
Dealt to Baksojor [8c 4s]
monetyche: folds
Demo666er: folds
Baksojor: folds
qk rodriguez: raises $0.10 to $0.15
MiyagiMaster: raises $0.35 to $0.50
Saf-Margo89: folds
qk rodriguez: folds
Uncalled bet ($0.35) returned to MiyagiMaster
MiyagiMaster collected $0.35 from pot
MiyagiMaster: doesn't show hand
*** SUMMARY ***
Total pot $0.35 | Rake $0
Seat 1: qk rodriguez (button) folded before Flop
Seat 2: MiyagiMaster (small blind) collected ($0.35)
Seat 3: Saf-Margo89 (big blind) folded before Flop
Seat 4: monetyche folded before Flop (didn't bet)
Seat 5: Demo666er folded before Flop (didn't bet)
Seat 6: Baksojor folded before Flop (didn't bet)


*********** # 151 **************
PokerStars Zoom Hand #174047704586:  Hold'em No Limit ($0.02/$0.05) - 2017/08/07 23:18:44 MSK [2017/08/07 16:18:44 ET]
Table 'Donati' 6-max Seat #1 is the button
Seat 1: Baksojor ($8.50 in chips)
Seat 2: Mikaeus ($5 in chips)
Seat 3: delgadolisto ($7.45 in chips)
Seat 4: momiasuk ($2.31 in chips)
Seat 5: balibalzow ($5.07 in chips)
Seat 6: Halaa16 ($23.92 in chips)
Mikaeus: posts small blind $0.02
delgadolisto: posts big blind $0.05
*** HOLE CARDS ***
Dealt to Baksojor [3s Qh]
momiasuk: folds
balibalzow: folds
Halaa16: folds
Baksojor: raises $0.05 to $0.10
Mikaeus: folds
delgadolisto: folds
Uncalled bet ($0.05) returned to Baksojor
Baksojor collected $0.12 from pot
Baksojor: doesn't show hand
*** SUMMARY ***
Total pot $0.12 | Rake $0
Seat 1: Baksojor (button) collected ($0.12)
Seat 2: Mikaeus (small blind) folded before Flop
Seat 3: delgadolisto (big blind) folded before Flop
Seat 4: momiasuk folded before Flop (didn't bet)
Seat 5: balibalzow folded before Flop (didn't bet)
Seat 6: Halaa16 folded before Flop (didn't bet)


*********** # 152 **************
PokerStars Zoom Hand #174047701299:  Hold'em No Limit ($0.02/$0.05) - 2017/08/07 23:18:40 MSK [2017/08/07 16:18:40 ET]
Table 'Donati' 6-max Seat #1 is the button
Seat 1: ElbowsKnees ($6.04 in chips)
Seat 2: Baksojor ($8.52 in chips)
Seat 3: akvest ($4.54 in chips)
Seat 4: antoxa oz ($14.60 in chips)
Seat 5: guilhermev85 ($5.18 in chips)
Seat 6: thoroldboy5 ($5.92 in chips)
Baksojor: posts small blind $0.02
akvest: posts big blind $0.05
*** HOLE CARDS ***
Dealt to Baksojor [7d 8c]
antoxa oz: folds
guilhermev85: folds
thoroldboy5: folds
ElbowsKnees: raises $0.05 to $0.10
Baksojor: folds
akvest: calls $0.05
*** FLOP *** [Jd 9h Kc]
akvest: checks
ElbowsKnees: bets $0.10
akvest: folds
Uncalled bet ($0.10) returned to ElbowsKnees
ElbowsKnees collected $0.21 from pot
ElbowsKnees: doesn't show hand
*** SUMMARY ***
Total pot $0.22 | Rake $0.01
Board [Jd 9h Kc]
Seat 1: ElbowsKnees (button) collected ($0.21)
Seat 2: Baksojor (small blind) folded before Flop
Seat 3: akvest (big blind) folded on the Flop
Seat 4: antoxa oz folded before Flop (didn't bet)
Seat 5: guilhermev85 folded before Flop (didn't bet)
Seat 6: thoroldboy5 folded before Flop (didn't bet)


*********** # 153 **************
PokerStars Zoom Hand #174047680083:  Hold'em No Limit ($0.02/$0.05) - 2017/08/07 23:18:13 MSK [2017/08/07 16:18:13 ET]
Table 'Donati' 6-max Seat #1 is the button
Seat 1: Gogenus ($3.92 in chips)
Seat 2: Rajkens ($4.84 in chips)
Seat 3: Baksojor ($8.37 in chips)
Seat 4: chraeder ($3.24 in chips)
Seat 5: -HAAwaiii- ($4.12 in chips)
Seat 6: whazzzup_010 ($7.83 in chips)
Rajkens: posts small blind $0.02
Baksojor: posts big blind $0.05
*** HOLE CARDS ***
Dealt to Baksojor [4s 3s]
chraeder: folds
-HAAwaiii-: folds
whazzzup_010: folds
Gogenus: folds
Rajkens: raises $0.10 to $0.15
Baksojor: raises $0.30 to $0.45
Rajkens: folds
Uncalled bet ($0.30) returned to Baksojor
Baksojor collected $0.30 from pot
Baksojor: doesn't show hand
*** SUMMARY ***
Total pot $0.30 | Rake $0
Seat 1: Gogenus (button) folded before Flop (didn't bet)
Seat 2: Rajkens (small blind) folded before Flop
Seat 3: Baksojor (big blind) collected ($0.30)
Seat 4: chraeder folded before Flop (didn't bet)
Seat 5: -HAAwaiii- folded before Flop (didn't bet)
Seat 6: whazzzup_010 folded before Flop (didn't bet)


*********** # 154 **************
PokerStars Zoom Hand #174047677062:  Hold'em No Limit ($0.02/$0.05) - 2017/08/07 23:18:09 MSK [2017/08/07 16:18:09 ET]
Table 'Donati' 6-max Seat #1 is the button
Seat 1: SHTYK27 ($1.86 in chips)
Seat 2: goldbunnies ($21.74 in chips)
Seat 3: jeliax ($5.19 in chips)
Seat 4: 5betblef ($8.19 in chips)
Seat 5: 7shun7 ($2.67 in chips)
Seat 6: Baksojor ($8.37 in chips)
goldbunnies: posts small blind $0.02
jeliax: posts big blind $0.05
*** HOLE CARDS ***
Dealt to Baksojor [4h Qc]
5betblef: folds
7shun7: folds
Baksojor: folds
SHTYK27: folds
goldbunnies: calls $0.03
jeliax: checks
*** FLOP *** [Th 9h 8d]
goldbunnies: bets $0.08
jeliax: calls $0.08
*** TURN *** [Th 9h 8d] [Ac]
goldbunnies: bets $0.14
jeliax: calls $0.14
*** RIVER *** [Th 9h 8d Ac] [Kh]
goldbunnies: bets $0.32
jeliax: folds
Uncalled bet ($0.32) returned to goldbunnies
goldbunnies collected $0.52 from pot
goldbunnies: doesn't show hand
*** SUMMARY ***
Total pot $0.54 | Rake $0.02
Board [Th 9h 8d Ac Kh]
Seat 1: SHTYK27 (button) folded before Flop (didn't bet)
Seat 2: goldbunnies (small blind) collected ($0.52)
Seat 3: jeliax (big blind) folded on the River
Seat 4: 5betblef folded before Flop (didn't bet)
Seat 5: 7shun7 folded before Flop (didn't bet)
Seat 6: Baksojor folded before Flop (didn't bet)


*********** # 155 **************
PokerStars Zoom Hand #174047673905:  Hold'em No Limit ($0.02/$0.05) - 2017/08/07 23:18:05 MSK [2017/08/07 16:18:05 ET]
Table 'Donati' 6-max Seat #1 is the button
Seat 1: TristrMistr ($33.68 in chips)
Seat 2: Baksojor ($8.39 in chips)
Seat 3: Dasha_1989 ($5.29 in chips)
Seat 4: x12x13 ($17.45 in chips)
Seat 5: balibalzow ($5.19 in chips)
Seat 6: xizza ($5.23 in chips)
Baksojor: posts small blind $0.02
Dasha_1989: posts big blind $0.05
*** HOLE CARDS ***
Dealt to Baksojor [Qh 6s]
x12x13: raises $0.10 to $0.15
balibalzow: folds
xizza: raises $0.33 to $0.48
TristrMistr: folds
Baksojor: folds
Dasha_1989: folds
x12x13: folds
Uncalled bet ($0.33) returned to xizza
xizza collected $0.37 from pot
xizza: doesn't show hand
*** SUMMARY ***
Total pot $0.37 | Rake $0
Seat 1: TristrMistr (button) folded before Flop (didn't bet)
Seat 2: Baksojor (small blind) folded before Flop
Seat 3: Dasha_1989 (big blind) folded before Flop
Seat 4: x12x13 folded before Flop
Seat 5: balibalzow folded before Flop (didn't bet)
Seat 6: xizza collected ($0.37)


*********** # 156 **************
PokerStars Zoom Hand #174047670702:  Hold'em No Limit ($0.02/$0.05) - 2017/08/07 23:18:01 MSK [2017/08/07 16:18:01 ET]
Table 'Donati' 6-max Seat #1 is the button
Seat 1: qk rodriguez ($12.62 in chips)
Seat 2: koribut ($5.02 in chips)
Seat 3: Warible ($8.45 in chips)
Seat 4: HATERS1337 ($7.05 in chips)
Seat 5: Baksojor ($8.39 in chips)
Seat 6: boxer821 ($5 in chips)
koribut: posts small blind $0.02
Warible: posts big blind $0.05
*** HOLE CARDS ***
Dealt to Baksojor [4c Jh]
HATERS1337: folds
Baksojor: folds
boxer821: folds
qk rodriguez: raises $0.10 to $0.15
koribut: folds
Warible: folds
Uncalled bet ($0.10) returned to qk rodriguez
qk rodriguez collected $0.12 from pot
qk rodriguez: doesn't show hand
*** SUMMARY ***
Total pot $0.12 | Rake $0
Seat 1: qk rodriguez (button) collected ($0.12)
Seat 2: koribut (small blind) folded before Flop
Seat 3: Warible (big blind) folded before Flop
Seat 4: HATERS1337 folded before Flop (didn't bet)
Seat 5: Baksojor folded before Flop (didn't bet)
Seat 6: boxer821 folded before Flop (didn't bet)


*********** # 157 **************
PokerStars Zoom Hand #174047639549:  Hold'em No Limit ($0.02/$0.05) - 2017/08/07 23:17:22 MSK [2017/08/07 16:17:22 ET]
Table 'Donati' 6-max Seat #1 is the button
Seat 1: boxer821 ($5.73 in chips)
Seat 2: tescaw ($5 in chips)
Seat 3: 7800-traek ($2.71 in chips)
Seat 4: chraeder ($1.80 in chips)
Seat 5: mag2110 ($3.96 in chips)
Seat 6: Baksojor ($5.65 in chips)
tescaw: posts small blind $0.02
7800-traek: posts big blind $0.05
*** HOLE CARDS ***
Dealt to Baksojor [Jc 8s]
chraeder: folds
mag2110: folds
Baksojor: raises $0.07 to $0.12
boxer821: raises $0.23 to $0.35
tescaw: folds
7800-traek: folds
Baksojor: calls $0.23
*** FLOP *** [Tc 4d 9c]
Baksojor: checks
boxer821: bets $0.37
Baksojor: raises $0.74 to $1.11
boxer821: calls $0.74
*** TURN *** [Tc 4d 9c] [Jh]
Baksojor: checks
boxer821: checks
*** RIVER *** [Tc 4d 9c Jh] [2h]
Baksojor: checks
boxer821: bets $1.46
Baksojor: calls $1.46
*** SHOW DOWN ***
boxer821: shows [Kd 9d] (a pair of Nines)
Baksojor: shows [Jc 8s] (a pair of Jacks)
Baksojor collected $5.66 from pot
*** SUMMARY ***
Total pot $5.91 | Rake $0.25
Board [Tc 4d 9c Jh 2h]
Seat 1: boxer821 (button) showed [Kd 9d] and lost with a pair of Nines
Seat 2: tescaw (small blind) folded before Flop
Seat 3: 7800-traek (big blind) folded before Flop
Seat 4: chraeder folded before Flop (didn't bet)
Seat 5: mag2110 folded before Flop (didn't bet)
Seat 6: Baksojor showed [Jc 8s] and won ($5.66) with a pair of Jacks


*********** # 158 **************
PokerStars Zoom Hand #174047632239:  Hold'em No Limit ($0.02/$0.05) - 2017/08/07 23:17:13 MSK [2017/08/07 16:17:13 ET]
Table 'Donati' 6-max Seat #1 is the button
Seat 1: Rybka1294 ($6 in chips)
Seat 2: kabocka ($1.98 in chips)
Seat 3: Baksojor ($5.70 in chips)
Seat 4: thoroldboy5 ($3.20 in chips)
Seat 5: DavidCâmara ($4.09 in chips)
Seat 6: Osiris7567 ($7.05 in chips)
kabocka: posts small blind $0.02
Baksojor: posts big blind $0.05
*** HOLE CARDS ***
Dealt to Baksojor [4d 9c]
thoroldboy5: raises $0.10 to $0.15
DavidCâmara: raises $3.94 to $4.09 and is all-in
Osiris7567: calls $4.09
Rybka1294: raises $1.91 to $6 and is all-in
kabocka: folds
Baksojor: folds
thoroldboy5: folds
Osiris7567: calls $1.91
*** FLOP *** [Jh 4c 7h]
*** TURN *** [Jh 4c 7h] [4s]
*** RIVER *** [Jh 4c 7h 4s] [3h]
*** SHOW DOWN ***
Osiris7567: shows [Kc Qh] (a pair of Fours)
Rybka1294: shows [Ac Ad] (two pair, Aces and Fours)
Rybka1294 collected $3.66 from side pot
DavidCâmara: shows [Kh 6c] (a pair of Fours)
Rybka1294 collected $11.97 from main pot
*** SUMMARY ***
Total pot $16.31 Main pot $11.97. Side pot $3.66. | Rake $0.68
Board [Jh 4c 7h 4s 3h]
Seat 1: Rybka1294 (button) showed [Ac Ad] and won ($15.63) with two pair, Aces and Fours
Seat 2: kabocka (small blind) folded before Flop
Seat 3: Baksojor (big blind) folded before Flop
Seat 4: thoroldboy5 folded before Flop
Seat 5: DavidCâmara showed [Kh 6c] and lost with a pair of Fours
Seat 6: Osiris7567 showed [Kc Qh] and lost with a pair of Fours


*********** # 159 **************
PokerStars Zoom Hand #174047625079:  Hold'em No Limit ($0.02/$0.05) - 2017/08/07 23:17:04 MSK [2017/08/07 16:17:04 ET]
Table 'Donati' 6-max Seat #1 is the button
Seat 1: Baksojor ($5.70 in chips)
Seat 2: Yahan588 ($5.10 in chips)
Seat 3: Siiing ($6.75 in chips)
Seat 4: Piensxl ($6.15 in chips)
Seat 5: thereraiserr ($3.65 in chips)
Seat 6: Naosky ($5.07 in chips)
Yahan588: posts small blind $0.02
Siiing: posts big blind $0.05
*** HOLE CARDS ***
Dealt to Baksojor [9h 5d]
Piensxl: folds
thereraiserr: folds
Naosky: raises $0.10 to $0.15
Baksojor: folds
Yahan588: raises $0.40 to $0.55
Siiing: folds
Naosky: folds
Uncalled bet ($0.40) returned to Yahan588
Yahan588 collected $0.35 from pot
Yahan588: doesn't show hand
*** SUMMARY ***
Total pot $0.35 | Rake $0
Seat 1: Baksojor (button) folded before Flop (didn't bet)
Seat 2: Yahan588 (small blind) collected ($0.35)
Seat 3: Siiing (big blind) folded before Flop
Seat 4: Piensxl folded before Flop (didn't bet)
Seat 5: thereraiserr folded before Flop (didn't bet)
Seat 6: Naosky folded before Flop


*********** # 160 **************
PokerStars Zoom Hand #174047613112:  Hold'em No Limit ($0.02/$0.05) - 2017/08/07 23:16:49 MSK [2017/08/07 16:16:49 ET]
Table 'Donati' 6-max Seat #1 is the button
Seat 1: klavdiya818 ($4.80 in chips)
Seat 2: twisky22 ($8.69 in chips)
Seat 3: Zolotoy66185 ($5 in chips)
Seat 4: goldbunnies ($21.53 in chips)
Seat 5: Baksojor ($5.63 in chips)
Seat 6: Panag88 ($5 in chips)
twisky22: posts small blind $0.02
Zolotoy66185: posts big blind $0.05
*** HOLE CARDS ***
Dealt to Baksojor [Jd As]
goldbunnies: folds
Baksojor: raises $0.10 to $0.15
Panag88: folds
klavdiya818: folds
twisky22: folds
Zolotoy66185: folds
Uncalled bet ($0.10) returned to Baksojor
Baksojor collected $0.12 from pot
Baksojor: doesn't show hand
*** SUMMARY ***
Total pot $0.12 | Rake $0
Seat 1: klavdiya818 (button) folded before Flop (didn't bet)
Seat 2: twisky22 (small blind) folded before Flop
Seat 3: Zolotoy66185 (big blind) folded before Flop
Seat 4: goldbunnies folded before Flop (didn't bet)
Seat 5: Baksojor collected ($0.12)
Seat 6: Panag88 folded before Flop (didn't bet)


*********** # 161 **************
PokerStars Zoom Hand #174047598780:  Hold'em No Limit ($0.02/$0.05) - 2017/08/07 23:16:31 MSK [2017/08/07 16:16:31 ET]
Table 'Donati' 6-max Seat #1 is the button
Seat 1: Baksojor ($5.73 in chips)
Seat 2: xizza ($5 in chips)
Seat 3: nodarik1980 ($5 in chips)
Seat 4: MaxCrown777 ($5.06 in chips)
Seat 5: ksrepin ($4.96 in chips)
Seat 6: rockycool04 ($9.47 in chips)
xizza: posts small blind $0.02
nodarik1980: posts big blind $0.05
*** HOLE CARDS ***
Dealt to Baksojor [4d Th]
MaxCrown777: folds
ksrepin: folds
rockycool04: folds
Baksojor: raises $0.05 to $0.10
xizza: folds
nodarik1980: raises $0.35 to $0.45
Baksojor: folds
Uncalled bet ($0.35) returned to nodarik1980
nodarik1980 collected $0.22 from pot
nodarik1980: doesn't show hand
*** SUMMARY ***
Total pot $0.22 | Rake $0
Seat 1: Baksojor (button) folded before Flop
Seat 2: xizza (small blind) folded before Flop
Seat 3: nodarik1980 (big blind) collected ($0.22)
Seat 4: MaxCrown777 folded before Flop (didn't bet)
Seat 5: ksrepin folded before Flop (didn't bet)
Seat 6: rockycool04 folded before Flop (didn't bet)


*********** # 162 **************
PokerStars Zoom Hand #174047595629:  Hold'em No Limit ($0.02/$0.05) - 2017/08/07 23:16:27 MSK [2017/08/07 16:16:27 ET]
Table 'Donati' 6-max Seat #1 is the button
Seat 1: ALF48 ($7.16 in chips)
Seat 2: Baksojor ($5.75 in chips)
Seat 3: vasinas ($2.64 in chips)
Seat 4: lasson87 ($4.17 in chips)
Seat 5: MaxCrown777 ($5.06 in chips)
Seat 6: markrh13 ($5 in chips)
Baksojor: posts small blind $0.02
vasinas: posts big blind $0.05
*** HOLE CARDS ***
Dealt to Baksojor [As 3h]
lasson87: raises $0.10 to $0.15
MaxCrown777: folds
markrh13: folds
ALF48: folds
Baksojor: folds
vasinas: folds
Uncalled bet ($0.10) returned to lasson87
lasson87 collected $0.12 from pot
lasson87: doesn't show hand
*** SUMMARY ***
Total pot $0.12 | Rake $0
Seat 1: ALF48 (button) folded before Flop (didn't bet)
Seat 2: Baksojor (small blind) folded before Flop
Seat 3: vasinas (big blind) folded before Flop
Seat 4: lasson87 collected ($0.12)
Seat 5: MaxCrown777 folded before Flop (didn't bet)
Seat 6: markrh13 folded before Flop (didn't bet)


*********** # 163 **************
PokerStars Zoom Hand #174047592420:  Hold'em No Limit ($0.02/$0.05) - 2017/08/07 23:16:23 MSK [2017/08/07 16:16:23 ET]
Table 'Donati' 6-max Seat #1 is the button
Seat 1: dimon36krut ($5.20 in chips)
Seat 2: la biere ($5.55 in chips)
Seat 3: Andr1972 ($5 in chips)
Seat 4: Baksojor ($5.75 in chips)
Seat 5: gehcastro ($7.40 in chips)
Seat 6: Flash91ua ($5 in chips)
la biere: posts small blind $0.02
Andr1972: posts big blind $0.05
*** HOLE CARDS ***
Dealt to Baksojor [Ac 8c]
Baksojor: folds
gehcastro: folds
Flash91ua: raises $0.10 to $0.15
dimon36krut: folds
la biere: folds
Andr1972: folds
Uncalled bet ($0.10) returned to Flash91ua
Flash91ua collected $0.12 from pot
Flash91ua: doesn't show hand
*** SUMMARY ***
Total pot $0.12 | Rake $0
Seat 1: dimon36krut (button) folded before Flop (didn't bet)
Seat 2: la biere (small blind) folded before Flop
Seat 3: Andr1972 (big blind) folded before Flop
Seat 4: Baksojor folded before Flop (didn't bet)
Seat 5: gehcastro folded before Flop (didn't bet)
Seat 6: Flash91ua collected ($0.12)


*********** # 164 **************
PokerStars Zoom Hand #174047589233:  Hold'em No Limit ($0.02/$0.05) - 2017/08/07 23:16:19 MSK [2017/08/07 16:16:19 ET]
Table 'Donati' 6-max Seat #1 is the button
Seat 1: markrh13 ($5 in chips)
Seat 2: vasinas ($3.23 in chips)
Seat 3: BigBoyStakes ($15.25 in chips)
Seat 4: Baksojor ($5.75 in chips)
Seat 5: gehcastro ($10.06 in chips)
Seat 6: lucky_gabbi ($6.17 in chips)
vasinas: posts small blind $0.02
BigBoyStakes: posts big blind $0.05
*** HOLE CARDS ***
Dealt to Baksojor [4s 9c]
Baksojor: folds
gehcastro: folds
lucky_gabbi: folds
markrh13: folds
vasinas: folds
Uncalled bet ($0.03) returned to BigBoyStakes
BigBoyStakes collected $0.04 from pot
BigBoyStakes: doesn't show hand
*** SUMMARY ***
Total pot $0.04 | Rake $0
Seat 1: markrh13 (button) folded before Flop (didn't bet)
Seat 2: vasinas (small blind) folded before Flop
Seat 3: BigBoyStakes (big blind) collected ($0.04)
Seat 4: Baksojor folded before Flop (didn't bet)
Seat 5: gehcastro folded before Flop (didn't bet)
Seat 6: lucky_gabbi folded before Flop (didn't bet)


*********** # 165 **************
PokerStars Zoom Hand #174047580498:  Hold'em No Limit ($0.02/$0.05) - 2017/08/07 23:16:08 MSK [2017/08/07 16:16:08 ET]
Table 'Donati' 6-max Seat #1 is the button
Seat 1: miniB!Gus ($4.05 in chips)
Seat 2: MiyagiMaster ($5.07 in chips)
Seat 3: Baksojor ($5.80 in chips)
Seat 4: Rybka1294 ($7.44 in chips)
Seat 5: kuzima_ge ($5 in chips)
Seat 6: jeliax ($8 in chips)
MiyagiMaster: posts small blind $0.02
Baksojor: posts big blind $0.05
*** HOLE CARDS ***
Dealt to Baksojor [2c Jh]
Rybka1294: folds
kuzima_ge: raises $0.07 to $0.12
jeliax: raises $0.28 to $0.40
miniB!Gus: folds
MiyagiMaster: folds
Baksojor: folds
kuzima_ge: raises $0.57 to $0.97
jeliax: calls $0.57
*** FLOP *** [5s 5d 8h]
kuzima_ge: bets $4.03 and is all-in
jeliax: calls $4.03
*** FIRST TURN *** [5s 5d 8h] [3d]
*** FIRST RIVER *** [5s 5d 8h 3d] [5h]
*** SECOND TURN *** [5s 5d 8h] [4d]
*** SECOND RIVER *** [5s 5d 8h 4d] [9d]
*** FIRST SHOW DOWN ***
kuzima_ge: shows [Ah As] (a full house, Fives full of Aces)
jeliax: shows [Tc Ts] (a full house, Fives full of Tens)
kuzima_ge collected $4.83 from pot
*** SECOND SHOW DOWN ***
kuzima_ge: shows [Ah As] (two pair, Aces and Fives)
jeliax: shows [Tc Ts] (two pair, Tens and Fives)
kuzima_ge collected $4.82 from pot
*** SUMMARY ***
Total pot $10.07 | Rake $0.42
Hand was run twice
FIRST Board [5s 5d 8h 3d 5h]
SECOND Board [5s 5d 8h 4d 9d]
Seat 1: miniB!Gus (button) folded before Flop (didn't bet)
Seat 2: MiyagiMaster (small blind) folded before Flop
Seat 3: Baksojor (big blind) folded before Flop
Seat 4: Rybka1294 folded before Flop (didn't bet)
Seat 5: kuzima_ge showed [Ah As] and won ($4.83) with a full house, Fives full of Aces, and won ($4.82) with two pair, Aces and Fives
Seat 6: jeliax showed [Tc Ts] and lost with a full house, Fives full of Tens, and lost with two pair, Tens and Fives


*********** # 166 **************
PokerStars Zoom Hand #174047575834:  Hold'em No Limit ($0.02/$0.05) - 2017/08/07 23:16:02 MSK [2017/08/07 16:16:02 ET]
Table 'Donati' 6-max Seat #1 is the button
Seat 1: goldbunnies ($21.48 in chips)
Seat 2: gehcastro ($7.42 in chips)
Seat 3: Hokus Pokeus ($20.46 in chips)
Seat 4: Pascoalabär ($5 in chips)
Seat 5: funkelia ($6.39 in chips)
Seat 6: Baksojor ($5.80 in chips)
gehcastro: posts small blind $0.02
Hokus Pokeus: posts big blind $0.05
*** HOLE CARDS ***
Dealt to Baksojor [8d 4h]
Pascoalabär: raises $0.10 to $0.15
funkelia: raises $0.37 to $0.52
Baksojor: folds
goldbunnies: folds
gehcastro: folds
Hokus Pokeus: folds
Pascoalabär: folds
Uncalled bet ($0.37) returned to funkelia
funkelia collected $0.37 from pot
funkelia: doesn't show hand
*** SUMMARY ***
Total pot $0.37 | Rake $0
Seat 1: goldbunnies (button) folded before Flop (didn't bet)
Seat 2: gehcastro (small blind) folded before Flop
Seat 3: Hokus Pokeus (big blind) folded before Flop
Seat 4: Pascoalabär folded before Flop
Seat 5: funkelia collected ($0.37)
Seat 6: Baksojor folded before Flop (didn't bet)


*********** # 167 **************
PokerStars Zoom Hand #174047571856:  Hold'em No Limit ($0.02/$0.05) - 2017/08/07 23:15:57 MSK [2017/08/07 16:15:57 ET]
Table 'Donati' 6-max Seat #1 is the button
Seat 1: MárioRJ ($6.79 in chips)
Seat 2: BrainGuru ($5.05 in chips)
Seat 3: JGold530 ($6.18 in chips)
Seat 4: Majkee88 ($5 in chips)
Seat 5: Baksojor ($5.80 in chips)
Seat 6: 999Monstr999 ($8.65 in chips)
BrainGuru: posts small blind $0.02
JGold530: posts big blind $0.05
*** HOLE CARDS ***
Dealt to Baksojor [4s 8c]
Majkee88: folds
Baksojor: folds
999Monstr999: raises $0.10 to $0.15
MárioRJ: calls $0.15
BrainGuru: raises $0.50 to $0.65
JGold530: folds
999Monstr999: folds
MárioRJ: folds
Uncalled bet ($0.50) returned to BrainGuru
BrainGuru collected $0.50 from pot
BrainGuru: doesn't show hand
*** SUMMARY ***
Total pot $0.50 | Rake $0
Seat 1: MárioRJ (button) folded before Flop
Seat 2: BrainGuru (small blind) collected ($0.50)
Seat 3: JGold530 (big blind) folded before Flop
Seat 4: Majkee88 folded before Flop (didn't bet)
Seat 5: Baksojor folded before Flop (didn't bet)
Seat 6: 999Monstr999 folded before Flop


*********** # 168 **************
PokerStars Zoom Hand #174047555212:  Hold'em No Limit ($0.02/$0.05) - 2017/08/07 23:15:36 MSK [2017/08/07 16:15:36 ET]
Table 'Donati' 6-max Seat #1 is the button
Seat 1: Baksojor ($5.73 in chips)
Seat 2: barmaley164 ($2.86 in chips)
Seat 3: Hokus Pokeus ($6.89 in chips)
Seat 4: CHOOS44 ($5.40 in chips)
Seat 5: b72rus ($6.92 in chips)
Seat 6: balibalzow ($5 in chips)
barmaley164: posts small blind $0.02
Hokus Pokeus: posts big blind $0.05
*** HOLE CARDS ***
Dealt to Baksojor [Kh 9h]
CHOOS44: folds
b72rus: folds
balibalzow: folds
Baksojor: raises $0.05 to $0.10
barmaley164: folds
Hokus Pokeus: folds
Uncalled bet ($0.05) returned to Baksojor
Baksojor collected $0.12 from pot
Baksojor: doesn't show hand
*** SUMMARY ***
Total pot $0.12 | Rake $0
Seat 1: Baksojor (button) collected ($0.12)
Seat 2: barmaley164 (small blind) folded before Flop
Seat 3: Hokus Pokeus (big blind) folded before Flop
Seat 4: CHOOS44 folded before Flop (didn't bet)
Seat 5: b72rus folded before Flop (didn't bet)
Seat 6: balibalzow folded before Flop (didn't bet)


*********** # 169 **************
PokerStars Zoom Hand #174047521748:  Hold'em No Limit ($0.02/$0.05) - 2017/08/07 23:14:54 MSK [2017/08/07 16:14:54 ET]
Table 'Donati' 6-max Seat #1 is the button
Seat 1: vasinas ($2.50 in chips)
Seat 2: Baksojor ($6.33 in chips)
Seat 3: AlberTSifon ($7.60 in chips)
Seat 4: StephBpee ($3.15 in chips)
Seat 5: Konkronus ($5.67 in chips)
Seat 6: bcw1983 ($4.98 in chips)
Baksojor: posts small blind $0.02
AlberTSifon: posts big blind $0.05
*** HOLE CARDS ***
Dealt to Baksojor [Qc Ah]
StephBpee: folds
Konkronus: folds
bcw1983: folds
vasinas: folds
Baksojor: raises $0.10 to $0.15
AlberTSifon: calls $0.10
*** FLOP *** [7c Jd 5h]
Baksojor: bets $0.15
AlberTSifon: calls $0.15
*** TURN *** [7c Jd 5h] [Tc]
Baksojor: bets $0.30
AlberTSifon: calls $0.30
*** RIVER *** [7c Jd 5h Tc] [4c]
Baksojor: checks
AlberTSifon: checks
*** SHOW DOWN ***
Baksojor: shows [Qc Ah] (high card Ace)
AlberTSifon: shows [Td 9s] (a pair of Tens)
AlberTSifon collected $1.15 from pot
*** SUMMARY ***
Total pot $1.20 | Rake $0.05
Board [7c Jd 5h Tc 4c]
Seat 1: vasinas (button) folded before Flop (didn't bet)
Seat 2: Baksojor (small blind) showed [Qc Ah] and lost with high card Ace
Seat 3: AlberTSifon (big blind) showed [Td 9s] and won ($1.15) with a pair of Tens
Seat 4: StephBpee folded before Flop (didn't bet)
Seat 5: Konkronus folded before Flop (didn't bet)
Seat 6: bcw1983 folded before Flop (didn't bet)


*********** # 170 **************
PokerStars Zoom Hand #174047474569:  Hold'em No Limit ($0.02/$0.05) - 2017/08/07 23:13:54 MSK [2017/08/07 16:13:54 ET]
Table 'Donati' 6-max Seat #1 is the button
Seat 1: b72rus ($7.23 in chips)
Seat 2: nordwolf27 ($6.06 in chips)
Seat 3: Baksojor ($6.68 in chips)
Seat 4: Felipepalme ($1.17 in chips)
Seat 5: anaconda199 ($8.90 in chips)
Seat 6: Demon31222 ($5.98 in chips)
nordwolf27: posts small blind $0.02
Baksojor: posts big blind $0.05
*** HOLE CARDS ***
Dealt to Baksojor [Td Th]
Felipepalme: folds
anaconda199: raises $0.05 to $0.10
Demon31222: raises $0.25 to $0.35
b72rus: folds
nordwolf27: folds
Baksojor: calls $0.30
anaconda199: calls $0.25
*** FLOP *** [7h 8s 2s]
Baksojor: checks
anaconda199: checks
Demon31222: checks
*** TURN *** [7h 8s 2s] [Qs]
Baksojor: checks
anaconda199: checks
Demon31222: bets $0.60
Baksojor: folds
anaconda199: calls $0.60
*** RIVER *** [7h 8s 2s Qs] [Ac]
anaconda199: checks
Demon31222: bets $1.25
anaconda199: calls $1.25
*** SHOW DOWN ***
Demon31222: shows [Ah Qd] (two pair, Aces and Queens)
anaconda199: mucks hand
Demon31222 collected $4.57 from pot
*** SUMMARY ***
Total pot $4.77 | Rake $0.20
Board [7h 8s 2s Qs Ac]
Seat 1: b72rus (button) folded before Flop (didn't bet)
Seat 2: nordwolf27 (small blind) folded before Flop
Seat 3: Baksojor (big blind) folded on the Turn
Seat 4: Felipepalme folded before Flop (didn't bet)
Seat 5: anaconda199 mucked [As Kh]
Seat 6: Demon31222 showed [Ah Qd] and won ($4.57) with two pair, Aces and Queens


*********** # 171 **************
PokerStars Zoom Hand #174047471481:  Hold'em No Limit ($0.02/$0.05) - 2017/08/07 23:13:50 MSK [2017/08/07 16:13:50 ET]
Table 'Donati' 6-max Seat #1 is the button
Seat 1: opg7 ($5.54 in chips)
Seat 2: 696den4ik696 ($4.64 in chips)
Seat 3: wowAAlolKK ($2.60 in chips)
Seat 4: Baksojor ($6.68 in chips)
Seat 5: Nerpa911 ($2.12 in chips)
Seat 6: Corwyntao ($5 in chips)
696den4ik696: posts small blind $0.02
wowAAlolKK: posts big blind $0.05
*** HOLE CARDS ***
Dealt to Baksojor [Qd 5h]
Baksojor: folds
Nerpa911: raises $0.10 to $0.15
Corwyntao: calls $0.15
opg7: calls $0.15
696den4ik696: calls $0.13
wowAAlolKK: folds
*** FLOP *** [Ts 4c 2s]
696den4ik696: checks
Nerpa911: bets $0.35
Corwyntao: folds
opg7: folds
696den4ik696: folds
Uncalled bet ($0.35) returned to Nerpa911
Nerpa911 collected $0.62 from pot
Nerpa911: doesn't show hand
*** SUMMARY ***
Total pot $0.65 | Rake $0.03
Board [Ts 4c 2s]
Seat 1: opg7 (button) folded on the Flop
Seat 2: 696den4ik696 (small blind) folded on the Flop
Seat 3: wowAAlolKK (big blind) folded before Flop
Seat 4: Baksojor folded before Flop (didn't bet)
Seat 5: Nerpa911 collected ($0.62)
Seat 6: Corwyntao folded on the Flop


*********** # 172 **************
PokerStars Zoom Hand #174047468239:  Hold'em No Limit ($0.02/$0.05) - 2017/08/07 23:13:46 MSK [2017/08/07 16:13:46 ET]
Table 'Donati' 6-max Seat #1 is the button
Seat 1: Pedrosophiaa ($11.35 in chips)
Seat 2: Conan0024 ($5.30 in chips)
Seat 3: Levmachinexx ($5.08 in chips)
Seat 4: Baksojor ($6.68 in chips)
Seat 5: mag2110 ($4.51 in chips)
Seat 6: MrInTerra ($4.96 in chips)
Conan0024: posts small blind $0.02
Levmachinexx: posts big blind $0.05
*** HOLE CARDS ***
Dealt to Baksojor [Jd Kh]
Baksojor: folds
mag2110: folds
MrInTerra: raises $0.10 to $0.15
Pedrosophiaa: folds
Conan0024: folds
Levmachinexx: folds
Uncalled bet ($0.10) returned to MrInTerra
MrInTerra collected $0.12 from pot
MrInTerra: doesn't show hand
*** SUMMARY ***
Total pot $0.12 | Rake $0
Seat 1: Pedrosophiaa (button) folded before Flop (didn't bet)
Seat 2: Conan0024 (small blind) folded before Flop
Seat 3: Levmachinexx (big blind) folded before Flop
Seat 4: Baksojor folded before Flop (didn't bet)
Seat 5: mag2110 folded before Flop (didn't bet)
Seat 6: MrInTerra collected ($0.12)


*********** # 173 **************
PokerStars Zoom Hand #174047464989:  Hold'em No Limit ($0.02/$0.05) - 2017/08/07 23:13:42 MSK [2017/08/07 16:13:42 ET]
Table 'Donati' 6-max Seat #1 is the button
Seat 1: koribut ($5.05 in chips)
Seat 2: Andr1972 ($5.53 in chips)
Seat 3: lucky_gabbi ($6.67 in chips)
Seat 4: sedoy0711 ($2.91 in chips)
Seat 5: FINTIFLYSHKI ($5.62 in chips)
Seat 6: Baksojor ($6.68 in chips)
Andr1972: posts small blind $0.02
lucky_gabbi: posts big blind $0.05
*** HOLE CARDS ***
Dealt to Baksojor [8h Qs]
sedoy0711: folds
FINTIFLYSHKI: folds
Baksojor: folds
koribut: folds
Andr1972: folds
Uncalled bet ($0.03) returned to lucky_gabbi
lucky_gabbi collected $0.04 from pot
lucky_gabbi: doesn't show hand
*** SUMMARY ***
Total pot $0.04 | Rake $0
Seat 1: koribut (button) folded before Flop (didn't bet)
Seat 2: Andr1972 (small blind) folded before Flop
Seat 3: lucky_gabbi (big blind) collected ($0.04)
Seat 4: sedoy0711 folded before Flop (didn't bet)
Seat 5: FINTIFLYSHKI folded before Flop (didn't bet)
Seat 6: Baksojor folded before Flop (didn't bet)


*********** # 174 **************
PokerStars Zoom Hand #174047456996:  Hold'em No Limit ($0.02/$0.05) - 2017/08/07 23:13:32 MSK [2017/08/07 16:13:32 ET]
Table 'Donati' 6-max Seat #1 is the button
Seat 1: goldbunnies ($19.88 in chips)
Seat 2: Baksojor ($6.70 in chips)
Seat 3: Bisi6611 ($5.80 in chips)
Seat 4: x_PALUCH_x ($3.05 in chips)
Seat 5: Levmachinexx ($5.47 in chips)
Seat 6: 8bruise8 ($12.33 in chips)
Baksojor: posts small blind $0.02
Bisi6611: posts big blind $0.05
*** HOLE CARDS ***
Dealt to Baksojor [Ts 7s]
x_PALUCH_x: raises $0.12 to $0.17
Levmachinexx: folds
8bruise8: folds
goldbunnies: folds
Baksojor: folds
Bisi6611: calls $0.12
*** FLOP *** [5d Ad 9s]
Bisi6611: checks
x_PALUCH_x: bets $0.35
Bisi6611: calls $0.35
*** TURN *** [5d Ad 9s] [Ac]
Bisi6611: checks
x_PALUCH_x: checks
*** RIVER *** [5d Ad 9s Ac] [6c]
Bisi6611: checks
x_PALUCH_x: checks
*** SHOW DOWN ***
Bisi6611: shows [5s 5h] (a full house, Fives full of Aces)
x_PALUCH_x: mucks hand
Bisi6611 collected $1.02 from pot
*** SUMMARY ***
Total pot $1.06 | Rake $0.04
Board [5d Ad 9s Ac 6c]
Seat 1: goldbunnies (button) folded before Flop (didn't bet)
Seat 2: Baksojor (small blind) folded before Flop
Seat 3: Bisi6611 (big blind) showed [5s 5h] and won ($1.02) with a full house, Fives full of Aces
Seat 4: x_PALUCH_x mucked [Jd Td]
Seat 5: Levmachinexx folded before Flop (didn't bet)
Seat 6: 8bruise8 folded before Flop (didn't bet)


*********** # 175 **************
PokerStars Zoom Hand #174047444321:  Hold'em No Limit ($0.02/$0.05) - 2017/08/07 23:13:16 MSK [2017/08/07 16:13:16 ET]
Table 'Donati' 6-max Seat #1 is the button
Seat 1: Baksojor ($6.70 in chips)
Seat 2: Gikson4a ($4.70 in chips)
Seat 3: Yahan588 ($5.92 in chips)
Seat 4: luis seifer ($0.91 in chips)
Seat 5: GucciGangAK ($10.69 in chips)
Seat 6: pawn811 ($17.36 in chips)
Gikson4a: posts small blind $0.02
Yahan588: posts big blind $0.05
*** HOLE CARDS ***
Dealt to Baksojor [3d Ts]
luis seifer: calls $0.05
GucciGangAK: folds
pawn811: folds
Baksojor: folds
Gikson4a: raises $0.10 to $0.15
Yahan588: folds
luis seifer: calls $0.10
*** FLOP *** [Jc 6s 9s]
Gikson4a: checks
luis seifer: bets $0.05
Gikson4a: calls $0.05
*** TURN *** [Jc 6s 9s] [6d]
Gikson4a: checks
luis seifer: bets $0.22
Gikson4a: folds
Uncalled bet ($0.22) returned to luis seifer
luis seifer collected $0.43 from pot
luis seifer: doesn't show hand
*** SUMMARY ***
Total pot $0.45 | Rake $0.02
Board [Jc 6s 9s 6d]
Seat 1: Baksojor (button) folded before Flop (didn't bet)
Seat 2: Gikson4a (small blind) folded on the Turn
Seat 3: Yahan588 (big blind) folded before Flop
Seat 4: luis seifer collected ($0.43)
Seat 5: GucciGangAK folded before Flop (didn't bet)
Seat 6: pawn811 folded before Flop (didn't bet)


*********** # 176 **************
PokerStars Zoom Hand #174047429252:  Hold'em No Limit ($0.02/$0.05) - 2017/08/07 23:12:57 MSK [2017/08/07 16:12:57 ET]
Table 'Donati' 6-max Seat #1 is the button
Seat 1: mag2110 ($4.56 in chips)
Seat 2: P3tz91 ($9.84 in chips)
Seat 3: Baksojor ($6.75 in chips)
Seat 4: RADemetrio ($12.82 in chips)
Seat 5: momiasuk ($2.23 in chips)
Seat 6: Jiko88 ($3.29 in chips)
P3tz91: posts small blind $0.02
Baksojor: posts big blind $0.05
*** HOLE CARDS ***
Dealt to Baksojor [2d Jc]
RADemetrio: folds
momiasuk: folds
Jiko88: folds
mag2110: folds
P3tz91: raises $0.10 to $0.15
Baksojor: folds
Uncalled bet ($0.10) returned to P3tz91
P3tz91 collected $0.10 from pot
P3tz91: doesn't show hand
*** SUMMARY ***
Total pot $0.10 | Rake $0
Seat 1: mag2110 (button) folded before Flop (didn't bet)
Seat 2: P3tz91 (small blind) collected ($0.10)
Seat 3: Baksojor (big blind) folded before Flop
Seat 4: RADemetrio folded before Flop (didn't bet)
Seat 5: momiasuk folded before Flop (didn't bet)
Seat 6: Jiko88 folded before Flop (didn't bet)


*********** # 177 **************
PokerStars Zoom Hand #174047425272:  Hold'em No Limit ($0.02/$0.05) - 2017/08/07 23:12:52 MSK [2017/08/07 16:12:52 ET]
Table 'Donati' 6-max Seat #1 is the button
Seat 1: L.I.N.1989 ($5.19 in chips)
Seat 2: Andr1972 ($6.91 in chips)
Seat 3: dimon36krut ($5 in chips)
Seat 4: Baksojor ($6.75 in chips)
Seat 5: x12x13 ($5.08 in chips)
Seat 6: xizza ($5 in chips)
Andr1972: posts small blind $0.02
dimon36krut: posts big blind $0.05
*** HOLE CARDS ***
Dealt to Baksojor [Td 5h]
Baksojor: folds
x12x13: folds
xizza: folds
L.I.N.1989: raises $0.07 to $0.12
Andr1972: folds
dimon36krut: folds
Uncalled bet ($0.07) returned to L.I.N.1989
L.I.N.1989 collected $0.12 from pot
L.I.N.1989: doesn't show hand
*** SUMMARY ***
Total pot $0.12 | Rake $0
Seat 1: L.I.N.1989 (button) collected ($0.12)
Seat 2: Andr1972 (small blind) folded before Flop
Seat 3: dimon36krut (big blind) folded before Flop
Seat 4: Baksojor folded before Flop (didn't bet)
Seat 5: x12x13 folded before Flop (didn't bet)
Seat 6: xizza folded before Flop (didn't bet)


*********** # 178 **************
PokerStars Zoom Hand #174047421332:  Hold'em No Limit ($0.02/$0.05) - 2017/08/07 23:12:47 MSK [2017/08/07 16:12:47 ET]
Table 'Donati' 6-max Seat #1 is the button
Seat 1: Andr1972 ($5.41 in chips)
Seat 2: vero7110 ($2 in chips)
Seat 3: Artili4 ($6.11 in chips)
Seat 4: anaconda199 ($8.12 in chips)
Seat 5: Baksojor ($6.75 in chips)
Seat 6: MiyagiMaster ($5.99 in chips)
vero7110: posts small blind $0.02
Artili4: posts big blind $0.05
*** HOLE CARDS ***
Dealt to Baksojor [Qh 2s]
anaconda199: calls $0.05
Baksojor: folds
MiyagiMaster: raises $0.07 to $0.12
Andr1972: folds
vero7110: raises $1.88 to $2 and is all-in
Artili4: folds
anaconda199: folds
MiyagiMaster: folds
Uncalled bet ($1.88) returned to vero7110
vero7110 collected $0.34 from pot
vero7110: doesn't show hand
*** SUMMARY ***
Total pot $0.34 | Rake $0
Seat 1: Andr1972 (button) folded before Flop (didn't bet)
Seat 2: vero7110 (small blind) collected ($0.34)
Seat 3: Artili4 (big blind) folded before Flop
Seat 4: anaconda199 folded before Flop
Seat 5: Baksojor folded before Flop (didn't bet)
Seat 6: MiyagiMaster folded before Flop


*********** # 179 **************
PokerStars Zoom Hand #174047384734:  Hold'em No Limit ($0.02/$0.05) - 2017/08/07 23:12:01 MSK [2017/08/07 16:12:01 ET]
Table 'Donati' 6-max Seat #1 is the button
Seat 1: whazzzup_010 ($8.33 in chips)
Seat 2: baozinq1 ($5.81 in chips)
Seat 3: oveandout ($4.09 in chips)
Seat 4: markrh13 ($4.98 in chips)
Seat 5: Zolotoy66185 ($3.87 in chips)
Seat 6: Baksojor ($5.99 in chips)
baozinq1: posts small blind $0.02
oveandout: posts big blind $0.05
*** HOLE CARDS ***
Dealt to Baksojor [Qh Qc]
markrh13: raises $0.10 to $0.15
Zolotoy66185: calls $0.15
Baksojor: raises $0.45 to $0.60
whazzzup_010: folds
baozinq1: folds
oveandout: folds
markrh13: folds
Zolotoy66185: calls $0.45
*** FLOP *** [9s 2s 3c]
Zolotoy66185: checks
Baksojor: bets $0.65
Zolotoy66185: folds
Uncalled bet ($0.65) returned to Baksojor
Baksojor collected $1.36 from pot
Baksojor: doesn't show hand
*** SUMMARY ***
Total pot $1.42 | Rake $0.06
Board [9s 2s 3c]
Seat 1: whazzzup_010 (button) folded before Flop (didn't bet)
Seat 2: baozinq1 (small blind) folded before Flop
Seat 3: oveandout (big blind) folded before Flop
Seat 4: markrh13 folded before Flop
Seat 5: Zolotoy66185 folded on the Flop
Seat 6: Baksojor collected ($1.36)


*********** # 180 **************
PokerStars Zoom Hand #174047381607:  Hold'em No Limit ($0.02/$0.05) - 2017/08/07 23:11:57 MSK [2017/08/07 16:11:57 ET]
Table 'Donati' 6-max Seat #1 is the button
Seat 1: InteRus13 ($9.56 in chips)
Seat 2: 2AceAndy ($9.81 in chips)
Seat 3: vasinas ($2.48 in chips)
Seat 4: Baksojor ($5.99 in chips)
Seat 5: Conan0024 ($5.28 in chips)
Seat 6: ABCSP71 ($2.55 in chips)
2AceAndy: posts small blind $0.02
vasinas: posts big blind $0.05
*** HOLE CARDS ***
Dealt to Baksojor [As 8d]
Baksojor: folds
Conan0024: raises $0.10 to $0.15
ABCSP71: folds
InteRus13: folds
2AceAndy: folds
vasinas: folds
Uncalled bet ($0.10) returned to Conan0024
Conan0024 collected $0.12 from pot
Conan0024: doesn't show hand
*** SUMMARY ***
Total pot $0.12 | Rake $0
Seat 1: InteRus13 (button) folded before Flop (didn't bet)
Seat 2: 2AceAndy (small blind) folded before Flop
Seat 3: vasinas (big blind) folded before Flop
Seat 4: Baksojor folded before Flop (didn't bet)
Seat 5: Conan0024 collected ($0.12)
Seat 6: ABCSP71 folded before Flop (didn't bet)


*********** # 181 **************
PokerStars Zoom Hand #174047375247:  Hold'em No Limit ($0.02/$0.05) - 2017/08/07 23:11:49 MSK [2017/08/07 16:11:49 ET]
Table 'Donati' 6-max Seat #1 is the button
Seat 1: Baksojor ($5.99 in chips)
Seat 2: gameflix ($12.22 in chips)
Seat 3: romaol ($15.47 in chips)
Seat 4: 5betblef ($6.47 in chips)
Seat 5: ElbowsKnees ($5.30 in chips)
Seat 6: Majkee88 ($12.47 in chips)
gameflix: posts small blind $0.02
romaol: posts big blind $0.05
*** HOLE CARDS ***
Dealt to Baksojor [5h Ac]
5betblef: folds
ElbowsKnees: folds
Majkee88: raises $0.10 to $0.15
Baksojor: folds
gameflix: folds
romaol: calls $0.10
*** FLOP *** [5s Qd Ad]
romaol: checks
Majkee88: bets $0.20
romaol: folds
Uncalled bet ($0.20) returned to Majkee88
Majkee88 collected $0.31 from pot
Majkee88: doesn't show hand
*** SUMMARY ***
Total pot $0.32 | Rake $0.01
Board [5s Qd Ad]
Seat 1: Baksojor (button) folded before Flop (didn't bet)
Seat 2: gameflix (small blind) folded before Flop
Seat 3: romaol (big blind) folded on the Flop
Seat 4: 5betblef folded before Flop (didn't bet)
Seat 5: ElbowsKnees folded before Flop (didn't bet)
Seat 6: Majkee88 collected ($0.31)


*********** # 182 **************
PokerStars Zoom Hand #174047326143:  Hold'em No Limit ($0.02/$0.05) - 2017/08/07 23:10:47 MSK [2017/08/07 16:10:47 ET]
Table 'Donati' 6-max Seat #1 is the button
Seat 1: Dasha_1989 ($5.17 in chips)
Seat 2: ketkulol ($5.81 in chips)
Seat 3: Baksojor ($6.44 in chips)
Seat 4: L.I.N.1989 ($6.05 in chips)
Seat 5: MárioRJ ($6.58 in chips)
Seat 6: CHOOS44 ($5.57 in chips)
ketkulol: posts small blind $0.02
Baksojor: posts big blind $0.05
*** HOLE CARDS ***
Dealt to Baksojor [Qh Th]
L.I.N.1989: folds
MárioRJ: folds
CHOOS44: folds
Dasha_1989: raises $0.07 to $0.12
ketkulol: folds
Baksojor: raises $0.33 to $0.45
Dasha_1989: calls $0.33
*** FLOP *** [As 9s 2s]
Baksojor: checks
Dasha_1989: bets $0.30
Baksojor: folds
Uncalled bet ($0.30) returned to Dasha_1989
Dasha_1989 collected $0.88 from pot
Dasha_1989: doesn't show hand
*** SUMMARY ***
Total pot $0.92 | Rake $0.04
Board [As 9s 2s]
Seat 1: Dasha_1989 (button) collected ($0.88)
Seat 2: ketkulol (small blind) folded before Flop
Seat 3: Baksojor (big blind) folded on the Flop
Seat 4: L.I.N.1989 folded before Flop (didn't bet)
Seat 5: MárioRJ folded before Flop (didn't bet)
Seat 6: CHOOS44 folded before Flop (didn't bet)


*********** # 183 **************
PokerStars Zoom Hand #174047322136:  Hold'em No Limit ($0.02/$0.05) - 2017/08/07 23:10:42 MSK [2017/08/07 16:10:42 ET]
Table 'Donati' 6-max Seat #1 is the button
Seat 1: boxer821 ($5 in chips)
Seat 2: Spartak985 ($8.09 in chips)
Seat 3: TristrMistr ($34 in chips)
Seat 4: wsad21 ($8 in chips)
Seat 5: Baksojor ($6.44 in chips)
Seat 6: 08-15am ($7.96 in chips)
Spartak985: posts small blind $0.02
TristrMistr: posts big blind $0.05
*** HOLE CARDS ***
Dealt to Baksojor [Ac 6h]
wsad21: folds
Baksojor: folds
08-15am: raises $0.10 to $0.15
boxer821: folds
Spartak985: folds
TristrMistr: folds
Uncalled bet ($0.10) returned to 08-15am
08-15am collected $0.12 from pot
08-15am: doesn't show hand
*** SUMMARY ***
Total pot $0.12 | Rake $0
Seat 1: boxer821 (button) folded before Flop (didn't bet)
Seat 2: Spartak985 (small blind) folded before Flop
Seat 3: TristrMistr (big blind) folded before Flop
Seat 4: wsad21 folded before Flop (didn't bet)
Seat 5: Baksojor folded before Flop (didn't bet)
Seat 6: 08-15am collected ($0.12)


*********** # 184 **************
PokerStars Zoom Hand #174047318942:  Hold'em No Limit ($0.02/$0.05) - 2017/08/07 23:10:38 MSK [2017/08/07 16:10:38 ET]
Table 'Donati' 6-max Seat #1 is the button
Seat 1: CHOOS44 ($5.53 in chips)
Seat 2: Baksojor ($6.46 in chips)
Seat 3: whazzzup_010 ($4.67 in chips)
Seat 4: guadz ($7.98 in chips)
Seat 5: kastchey_azo ($3.01 in chips)
Seat 6: barmaley164 ($4.93 in chips)
Baksojor: posts small blind $0.02
whazzzup_010: posts big blind $0.05
*** HOLE CARDS ***
Dealt to Baksojor [As 6c]
guadz: folds
kastchey_azo: folds
barmaley164: calls $0.05
CHOOS44: folds
Baksojor: folds
whazzzup_010: checks
*** FLOP *** [9c 5d Qs]
whazzzup_010: checks
barmaley164: checks
*** TURN *** [9c 5d Qs] [9h]
whazzzup_010: checks
barmaley164: bets $0.15
whazzzup_010: folds
Uncalled bet ($0.15) returned to barmaley164
barmaley164 collected $0.12 from pot
barmaley164: doesn't show hand
*** SUMMARY ***
Total pot $0.12 | Rake $0
Board [9c 5d Qs 9h]
Seat 1: CHOOS44 (button) folded before Flop (didn't bet)
Seat 2: Baksojor (small blind) folded before Flop
Seat 3: whazzzup_010 (big blind) folded on the Turn
Seat 4: guadz folded before Flop (didn't bet)
Seat 5: kastchey_azo folded before Flop (didn't bet)
Seat 6: barmaley164 collected ($0.12)


*********** # 185 **************
PokerStars Zoom Hand #174047315782:  Hold'em No Limit ($0.02/$0.05) - 2017/08/07 23:10:34 MSK [2017/08/07 16:10:34 ET]
Table 'Donati' 6-max Seat #1 is the button
Seat 1: thoroldboy5 ($3.05 in chips)
Seat 2: ryanshire94 ($7.84 in chips)
Seat 3: MSKLucky007 ($5 in chips)
Seat 4: !REAL!PrisoN ($14.58 in chips)
Seat 5: whazzzup_010 ($4.67 in chips)
Seat 6: Baksojor ($6.46 in chips)
ryanshire94: posts small blind $0.02
MSKLucky007: posts big blind $0.05
*** HOLE CARDS ***
Dealt to Baksojor [4c 3s]
!REAL!PrisoN: folds
whazzzup_010: folds
Baksojor: folds
thoroldboy5: calls $0.05
ryanshire94: calls $0.03
MSKLucky007: checks
*** FLOP *** [Td 9s 4d]
ryanshire94: checks
MSKLucky007: checks
thoroldboy5: checks
*** TURN *** [Td 9s 4d] [Kc]
ryanshire94: checks
MSKLucky007: checks
thoroldboy5: checks
*** RIVER *** [Td 9s 4d Kc] [4h]
ryanshire94: checks
MSKLucky007: checks
thoroldboy5: checks
*** SHOW DOWN ***
ryanshire94: shows [8h 9h] (two pair, Nines and Fours)
MSKLucky007: mucks hand
thoroldboy5: mucks hand
ryanshire94 collected $0.14 from pot
*** SUMMARY ***
Total pot $0.15 | Rake $0.01
Board [Td 9s 4d Kc 4h]
Seat 1: thoroldboy5 (button) mucked [3d Ac]
Seat 2: ryanshire94 (small blind) showed [8h 9h] and won ($0.14) with two pair, Nines and Fours
Seat 3: MSKLucky007 (big blind) mucked [2d 5c]
Seat 4: !REAL!PrisoN folded before Flop (didn't bet)
Seat 5: whazzzup_010 folded before Flop (didn't bet)
Seat 6: Baksojor folded before Flop (didn't bet)


*********** # 186 **************
PokerStars Zoom Hand #174047312561:  Hold'em No Limit ($0.02/$0.05) - 2017/08/07 23:10:30 MSK [2017/08/07 16:10:30 ET]
Table 'Donati' 6-max Seat #1 is the button
Seat 1: nodarik1980 ($5.62 in chips)
Seat 2: boxer821 ($5 in chips)
Seat 3: Nerpa911 ($2.01 in chips)
Seat 4: Swing1025 ($52.91 in chips)
Seat 5: Baksojor ($6.46 in chips)
Seat 6: Ray1337996 ($4.10 in chips)
boxer821: posts small blind $0.02
Nerpa911: posts big blind $0.05
*** HOLE CARDS ***
Dealt to Baksojor [2c Th]
Swing1025: folds
Baksojor: folds
Ray1337996: raises $0.10 to $0.15
nodarik1980: folds
boxer821: raises $0.35 to $0.50
Nerpa911: folds
Ray1337996: folds
Uncalled bet ($0.35) returned to boxer821
boxer821 collected $0.35 from pot
boxer821: doesn't show hand
*** SUMMARY ***
Total pot $0.35 | Rake $0
Seat 1: nodarik1980 (button) folded before Flop (didn't bet)
Seat 2: boxer821 (small blind) collected ($0.35)
Seat 3: Nerpa911 (big blind) folded before Flop
Seat 4: Swing1025 folded before Flop (didn't bet)
Seat 5: Baksojor folded before Flop (didn't bet)
Seat 6: Ray1337996 folded before Flop


*********** # 187 **************
PokerStars Zoom Hand #174047309391:  Hold'em No Limit ($0.02/$0.05) - 2017/08/07 23:10:26 MSK [2017/08/07 16:10:26 ET]
Table 'Donati' 6-max Seat #1 is the button
Seat 1: xsikor02 ($5.39 in chips)
Seat 2: Baksojor ($6.48 in chips)
Seat 3: fafernandez9 ($6.71 in chips)
Seat 4: glatti2005 ($5.24 in chips)
Seat 5: pillippo666 ($1.04 in chips)
Seat 6: t$unami cr ($6.26 in chips)
Baksojor: posts small blind $0.02
fafernandez9: posts big blind $0.05
*** HOLE CARDS ***
Dealt to Baksojor [Ah 6c]
glatti2005: folds
pillippo666: raises $0.10 to $0.15
t$unami cr: folds
xsikor02: folds
Baksojor: folds
fafernandez9: calls $0.10
*** FLOP *** [8h 6s Jh]
fafernandez9: checks
pillippo666: checks
*** TURN *** [8h 6s Jh] [7s]
fafernandez9: checks
pillippo666: checks
*** RIVER *** [8h 6s Jh 7s] [8d]
fafernandez9: checks
pillippo666: checks
*** SHOW DOWN ***
fafernandez9: shows [5d 3d] (a pair of Eights)
pillippo666: shows [4d Ac] (a pair of Eights - Ace kicker)
pillippo666 collected $0.31 from pot
*** SUMMARY ***
Total pot $0.32 | Rake $0.01
Board [8h 6s Jh 7s 8d]
Seat 1: xsikor02 (button) folded before Flop (didn't bet)
Seat 2: Baksojor (small blind) folded before Flop
Seat 3: fafernandez9 (big blind) showed [5d 3d] and lost with a pair of Eights
Seat 4: glatti2005 folded before Flop (didn't bet)
Seat 5: pillippo666 showed [4d Ac] and won ($0.31) with a pair of Eights
Seat 6: t$unami cr folded before Flop (didn't bet)


*********** # 188 **************
PokerStars Zoom Hand #174047303722:  Hold'em No Limit ($0.02/$0.05) - 2017/08/07 23:10:19 MSK [2017/08/07 16:10:19 ET]
Table 'Donati' 6-max Seat #1 is the button
Seat 1: Baksojor ($6.48 in chips)
Seat 2: ryanshire94 ($7.86 in chips)
Seat 3: iron79571 ($14.01 in chips)
Seat 4: MiyagiMaster ($5.25 in chips)
Seat 5: whazzzup_010 ($4.69 in chips)
Seat 6: Gikson4a ($6.22 in chips)
ryanshire94: posts small blind $0.02
iron79571: posts big blind $0.05
*** HOLE CARDS ***
Dealt to Baksojor [2c Qd]
MiyagiMaster: raises $0.10 to $0.15
whazzzup_010: folds
Gikson4a: calls $0.15
Baksojor: folds
ryanshire94: folds
iron79571: folds
*** FLOP *** [Tc Jd 6h]
MiyagiMaster: checks
Gikson4a: bets $0.20
MiyagiMaster: folds
Uncalled bet ($0.20) returned to Gikson4a
Gikson4a collected $0.35 from pot
Gikson4a: doesn't show hand
*** SUMMARY ***
Total pot $0.37 | Rake $0.02
Board [Tc Jd 6h]
Seat 1: Baksojor (button) folded before Flop (didn't bet)
Seat 2: ryanshire94 (small blind) folded before Flop
Seat 3: iron79571 (big blind) folded before Flop
Seat 4: MiyagiMaster folded on the Flop
Seat 5: whazzzup_010 folded before Flop (didn't bet)
Seat 6: Gikson4a collected ($0.35)


*********** # 189 **************
PokerStars Zoom Hand #174047289492:  Hold'em No Limit ($0.02/$0.05) - 2017/08/07 23:10:01 MSK [2017/08/07 16:10:01 ET]
Table 'Donati' 6-max Seat #1 is the button
Seat 1: YmanB ($2.50 in chips)
Seat 2: delgadolisto ($5.04 in chips)
Seat 3: Baksojor ($6.46 in chips)
Seat 4: PayForSee ($6.32 in chips)
Seat 5: ilovezone214 ($5.98 in chips)
Seat 6: otecvovan ($4.95 in chips)
delgadolisto: posts small blind $0.02
Baksojor: posts big blind $0.05
*** HOLE CARDS ***
Dealt to Baksojor [8c 4d]
PayForSee: folds
ilovezone214: folds
otecvovan: folds
YmanB: folds
delgadolisto: folds
Uncalled bet ($0.03) returned to Baksojor
Baksojor collected $0.04 from pot
Baksojor: doesn't show hand
*** SUMMARY ***
Total pot $0.04 | Rake $0
Seat 1: YmanB (button) folded before Flop (didn't bet)
Seat 2: delgadolisto (small blind) folded before Flop
Seat 3: Baksojor (big blind) collected ($0.04)
Seat 4: PayForSee folded before Flop (didn't bet)
Seat 5: ilovezone214 folded before Flop (didn't bet)
Seat 6: otecvovan folded before Flop (didn't bet)


*********** # 190 **************
PokerStars Zoom Hand #174047246898:  Hold'em No Limit ($0.02/$0.05) - 2017/08/07 23:09:07 MSK [2017/08/07 16:09:07 ET]
Table 'Donati' 6-max Seat #1 is the button
Seat 1: TristrMistr ($34.81 in chips)
Seat 2: Saf-Margo89 ($0.71 in chips)
Seat 3: Chrisse141 ($10.67 in chips)
Seat 4: Baksojor ($5.73 in chips)
Seat 5: gelo$av ($3.95 in chips)
Seat 6: Thedude9212 ($4.37 in chips)
Saf-Margo89: posts small blind $0.02
Chrisse141: posts big blind $0.05
*** HOLE CARDS ***
Dealt to Baksojor [Qd Qh]
Baksojor: raises $0.07 to $0.12
gelo$av: folds
Thedude9212: folds
TristrMistr: calls $0.12
Saf-Margo89: folds
Chrisse141: folds
*** FLOP *** [9c 6c 5s]
Baksojor: bets $0.20
TristrMistr: calls $0.20
*** TURN *** [9c 6c 5s] [As]
Baksojor: checks
TristrMistr: checks
*** RIVER *** [9c 6c 5s As] [Ad]
Baksojor: bets $0.40
TristrMistr: calls $0.40
*** SHOW DOWN ***
Baksojor: shows [Qd Qh] (two pair, Aces and Queens)
TristrMistr: mucks hand
Baksojor collected $1.45 from pot
*** SUMMARY ***
Total pot $1.51 | Rake $0.06
Board [9c 6c 5s As Ad]
Seat 1: TristrMistr (button) mucked [6s 7s]
Seat 2: Saf-Margo89 (small blind) folded before Flop
Seat 3: Chrisse141 (big blind) folded before Flop
Seat 4: Baksojor showed [Qd Qh] and won ($1.45) with two pair, Aces and Queens
Seat 5: gelo$av folded before Flop (didn't bet)
Seat 6: Thedude9212 folded before Flop (didn't bet)


*********** # 191 **************
PokerStars Zoom Hand #174047243744:  Hold'em No Limit ($0.02/$0.05) - 2017/08/07 23:09:03 MSK [2017/08/07 16:09:03 ET]
Table 'Donati' 6-max Seat #1 is the button
Seat 1: Valerij V.S. ($2.21 in chips)
Seat 2: onootooole ($3.18 in chips)
Seat 3: maliniak75 ($7.44 in chips)
Seat 4: MiyagiMaster ($5.30 in chips)
Seat 5: Girigal ($6.41 in chips)
Seat 6: Baksojor ($5.73 in chips)
onootooole: posts small blind $0.02
maliniak75: posts big blind $0.05
*** HOLE CARDS ***
Dealt to Baksojor [8c Th]
MiyagiMaster: folds
Girigal: folds
Baksojor: folds
Valerij V.S.: raises $0.05 to $0.10
onootooole: folds
maliniak75 has timed out while disconnected
maliniak75: folds
Uncalled bet ($0.05) returned to Valerij V.S.
Valerij V.S. collected $0.12 from pot
Valerij V.S.: doesn't show hand
*** SUMMARY ***
Total pot $0.12 | Rake $0
Seat 1: Valerij V.S. (button) collected ($0.12)
Seat 2: onootooole (small blind) folded before Flop
Seat 3: maliniak75 (big blind) folded before Flop
Seat 4: MiyagiMaster folded before Flop (didn't bet)
Seat 5: Girigal folded before Flop (didn't bet)
Seat 6: Baksojor folded before Flop (didn't bet)


*********** # 192 **************
PokerStars Zoom Hand #174047240541:  Hold'em No Limit ($0.02/$0.05) - 2017/08/07 23:08:59 MSK [2017/08/07 16:08:59 ET]
Table 'Donati' 6-max Seat #1 is the button
Seat 1: miniB!Gus ($4.24 in chips)
Seat 2: Baksojor ($5.75 in chips)
Seat 3: GORYS10 ($5.97 in chips)
Seat 4: Hottedxd ($24.29 in chips)
Seat 5: taygabi02 ($5.46 in chips)
Seat 6: Poguh ($5.33 in chips)
Baksojor: posts small blind $0.02
GORYS10: posts big blind $0.05
*** HOLE CARDS ***
Dealt to Baksojor [5s 9s]
Hottedxd: raises $0.10 to $0.15
taygabi02: folds
Poguh: folds
miniB!Gus: folds
Baksojor: folds
GORYS10: calls $0.10
*** FLOP *** [5d Ac Qh]
GORYS10: checks
Hottedxd: bets $0.20
GORYS10: calls $0.20
*** TURN *** [5d Ac Qh] [Ks]
GORYS10: checks
Hottedxd: checks
*** RIVER *** [5d Ac Qh Ks] [5c]
GORYS10: bets $0.35
Hottedxd: folds
Uncalled bet ($0.35) returned to GORYS10
GORYS10 collected $0.69 from pot
GORYS10: doesn't show hand
*** SUMMARY ***
Total pot $0.72 | Rake $0.03
Board [5d Ac Qh Ks 5c]
Seat 1: miniB!Gus (button) folded before Flop (didn't bet)
Seat 2: Baksojor (small blind) folded before Flop
Seat 3: GORYS10 (big blind) collected ($0.69)
Seat 4: Hottedxd folded on the River
Seat 5: taygabi02 folded before Flop (didn't bet)
Seat 6: Poguh folded before Flop (didn't bet)


*********** # 193 **************
PokerStars Zoom Hand #174047230338:  Hold'em No Limit ($0.02/$0.05) - 2017/08/07 23:08:46 MSK [2017/08/07 16:08:46 ET]
Table 'Donati' 6-max Seat #1 is the button
Seat 1: Baksojor ($5.75 in chips)
Seat 2: SH3MYAK ($4.52 in chips)
Seat 3: dimasps12 ($2.76 in chips)
Seat 4: bid-city ($10.05 in chips)
Seat 5: bajinege ($5 in chips)
Seat 6: My4Street ($7.10 in chips)
SH3MYAK: posts small blind $0.02
dimasps12: posts big blind $0.05
*** HOLE CARDS ***
Dealt to Baksojor [Js 2s]
bid-city: folds
bajinege: folds
My4Street: raises $0.07 to $0.12
Baksojor: folds
SH3MYAK: folds
dimasps12: folds
Uncalled bet ($0.07) returned to My4Street
My4Street collected $0.12 from pot
My4Street: doesn't show hand
*** SUMMARY ***
Total pot $0.12 | Rake $0
Seat 1: Baksojor (button) folded before Flop (didn't bet)
Seat 2: SH3MYAK (small blind) folded before Flop
Seat 3: dimasps12 (big blind) folded before Flop
Seat 4: bid-city folded before Flop (didn't bet)
Seat 5: bajinege folded before Flop (didn't bet)
Seat 6: My4Street collected ($0.12)


*********** # 194 **************
PokerStars Zoom Hand #174047204931:  Hold'em No Limit ($0.02/$0.05) - 2017/08/07 23:08:14 MSK [2017/08/07 16:08:14 ET]
Table 'Donati' 6-max Seat #1 is the button
Seat 1: drolete197 ($7.41 in chips)
Seat 2: Best5555 ($5 in chips)
Seat 3: TristrMistr ($50.25 in chips)
Seat 4: Baksojor ($5.39 in chips)
Seat 5: qk rodriguez ($6.10 in chips)
Seat 6: Aleks Ryder ($39.84 in chips)
Best5555: posts small blind $0.02
TristrMistr: posts big blind $0.05
*** HOLE CARDS ***
Dealt to Baksojor [Kh Jh]
Baksojor: raises $0.07 to $0.12
qk rodriguez: calls $0.12
Aleks Ryder: folds
drolete197: calls $0.12
Best5555: folds
TristrMistr: calls $0.07
*** FLOP *** [4d Jd Ts]
TristrMistr: checks
Baksojor: bets $0.32
qk rodriguez: folds
drolete197: folds
TristrMistr: folds
Uncalled bet ($0.32) returned to Baksojor
Baksojor collected $0.48 from pot
Baksojor: doesn't show hand
*** SUMMARY ***
Total pot $0.50 | Rake $0.02
Board [4d Jd Ts]
Seat 1: drolete197 (button) folded on the Flop
Seat 2: Best5555 (small blind) folded before Flop
Seat 3: TristrMistr (big blind) folded on the Flop
Seat 4: Baksojor collected ($0.48)
Seat 5: qk rodriguez folded on the Flop
Seat 6: Aleks Ryder folded before Flop (didn't bet)


*********** # 195 **************
PokerStars Zoom Hand #174047201713:  Hold'em No Limit ($0.02/$0.05) - 2017/08/07 23:08:10 MSK [2017/08/07 16:08:10 ET]
Table 'Donati' 6-max Seat #1 is the button
Seat 1: nightwolfpro ($5.49 in chips)
Seat 2: win56987 ($5.09 in chips)
Seat 3: zen approach ($5 in chips)
Seat 4: Baksojor ($5.39 in chips)
Seat 5: pawn811 ($11.91 in chips)
Seat 6: Rybka1294 ($7.52 in chips)
win56987: posts small blind $0.02
zen approach: posts big blind $0.05
*** HOLE CARDS ***
Dealt to Baksojor [3d Qh]
Baksojor: folds
pawn811: folds
Rybka1294: raises $0.07 to $0.12
nightwolfpro: folds
win56987: calls $0.10
zen approach: folds
*** FLOP *** [7c As 8s]
win56987: checks
Rybka1294: checks
*** TURN *** [7c As 8s] [Jd]
win56987: checks
Rybka1294: bets $0.20
win56987: calls $0.20
*** RIVER *** [7c As 8s Jd] [2s]
win56987: checks
Rybka1294: checks
*** SHOW DOWN ***
win56987: shows [Ks Jh] (a pair of Jacks)
Rybka1294: shows [Ah 4h] (a pair of Aces)
Rybka1294 collected $0.66 from pot
*** SUMMARY ***
Total pot $0.69 | Rake $0.03
Board [7c As 8s Jd 2s]
Seat 1: nightwolfpro (button) folded before Flop (didn't bet)
Seat 2: win56987 (small blind) showed [Ks Jh] and lost with a pair of Jacks
Seat 3: zen approach (big blind) folded before Flop
Seat 4: Baksojor folded before Flop (didn't bet)
Seat 5: pawn811 folded before Flop (didn't bet)
Seat 6: Rybka1294 showed [Ah 4h] and won ($0.66) with a pair of Aces


*********** # 196 **************
PokerStars Zoom Hand #174047198612:  Hold'em No Limit ($0.02/$0.05) - 2017/08/07 23:08:06 MSK [2017/08/07 16:08:06 ET]
Table 'Donati' 6-max Seat #1 is the button
Seat 1: Auyber ($20.96 in chips)
Seat 2: Caffezord ($15.02 in chips)
Seat 3: aslk ($9.37 in chips)
Seat 4: Master_Ad776 ($5 in chips)
Seat 5: Baksojor ($5.39 in chips)
Seat 6: Levmachinexx ($6.83 in chips)
Caffezord: posts small blind $0.02
aslk: posts big blind $0.05
*** HOLE CARDS ***
Dealt to Baksojor [Ad 4c]
Master_Ad776: folds
Baksojor: folds
Levmachinexx: folds
Auyber: folds
Caffezord: folds
Uncalled bet ($0.03) returned to aslk
aslk collected $0.04 from pot
aslk: doesn't show hand
*** SUMMARY ***
Total pot $0.04 | Rake $0
Seat 1: Auyber (button) folded before Flop (didn't bet)
Seat 2: Caffezord (small blind) folded before Flop
Seat 3: aslk (big blind) collected ($0.04)
Seat 4: Master_Ad776 folded before Flop (didn't bet)
Seat 5: Baksojor folded before Flop (didn't bet)
Seat 6: Levmachinexx folded before Flop (didn't bet)


*********** # 197 **************
PokerStars Zoom Hand #174047193882:  Hold'em No Limit ($0.02/$0.05) - 2017/08/07 23:08:00 MSK [2017/08/07 16:08:00 ET]
Table 'Donati' 6-max Seat #1 is the button
Seat 1: Anton Tr ($5 in chips)
Seat 2: Dasha_1989 ($5.02 in chips)
Seat 3: Baksojor ($5.44 in chips)
Seat 4: drolete197 ($7.34 in chips)
Seat 5: dimasps12 ($3.55 in chips)
Seat 6: Pechkin85 ($5.35 in chips)
Dasha_1989: posts small blind $0.02
Baksojor: posts big blind $0.05
*** HOLE CARDS ***
Dealt to Baksojor [Qd 3c]
drolete197: raises $0.10 to $0.15
dimasps12: folds
Pechkin85: folds
Anton Tr: folds
Dasha_1989: folds
Baksojor: folds
Uncalled bet ($0.10) returned to drolete197
drolete197 collected $0.12 from pot
drolete197: doesn't show hand
*** SUMMARY ***
Total pot $0.12 | Rake $0
Seat 1: Anton Tr (button) folded before Flop (didn't bet)
Seat 2: Dasha_1989 (small blind) folded before Flop
Seat 3: Baksojor (big blind) folded before Flop
Seat 4: drolete197 collected ($0.12)
Seat 5: dimasps12 folded before Flop (didn't bet)
Seat 6: Pechkin85 folded before Flop (didn't bet)


*********** # 198 **************
PokerStars Zoom Hand #174047170977:  Hold'em No Limit ($0.02/$0.05) - 2017/08/07 23:07:31 MSK [2017/08/07 16:07:31 ET]
Table 'Donati' 6-max Seat #1 is the button
Seat 1: ksrepin ($5.23 in chips)
Seat 2: MSKLucky007 ($5.07 in chips)
Seat 3: .NS.000 ($2.70 in chips)
Seat 4: mag2110 ($3.29 in chips)
Seat 5: Baksojor ($5.26 in chips)
Seat 6: xander33911 ($6.14 in chips)
MSKLucky007: posts small blind $0.02
 .NS.000: posts big blind $0.05
*** HOLE CARDS ***
Dealt to Baksojor [7c Ac]
mag2110: folds
Baksojor: raises $0.07 to $0.12
xander33911: calls $0.12
ksrepin: folds
MSKLucky007: folds
 .NS.000: folds
*** FLOP *** [Qd 7d 2h]
Baksojor: bets $0.15
xander33911: folds
Uncalled bet ($0.15) returned to Baksojor
Baksojor collected $0.30 from pot
Baksojor: doesn't show hand
*** SUMMARY ***
Total pot $0.31 | Rake $0.01
Board [Qd 7d 2h]
Seat 1: ksrepin (button) folded before Flop (didn't bet)
Seat 2: MSKLucky007 (small blind) folded before Flop
Seat 3: .NS.000 (big blind) folded before Flop
Seat 4: mag2110 folded before Flop (didn't bet)
Seat 5: Baksojor collected ($0.30)
Seat 6: xander33911 folded on the Flop


*********** # 199 **************
PokerStars Zoom Hand #174047156755:  Hold'em No Limit ($0.02/$0.05) - 2017/08/07 23:07:13 MSK [2017/08/07 16:07:13 ET]
Table 'Donati' 6-max Seat #1 is the button
Seat 1: IldarD86 ($5.05 in chips)
Seat 2: BigBoyStakes ($9.86 in chips)
Seat 3: disident365 ($5.49 in chips)
Seat 4: OMG DerClown ($4.37 in chips)
Seat 5: qk rodriguez ($5.07 in chips)
Seat 6: Baksojor ($5.19 in chips)
BigBoyStakes: posts small blind $0.02
disident365: posts big blind $0.05
*** HOLE CARDS ***
Dealt to Baksojor [Ah 7c]
OMG DerClown: folds
qk rodriguez: folds
Baksojor: raises $0.07 to $0.12
IldarD86: folds
BigBoyStakes: folds
disident365: folds
Uncalled bet ($0.07) returned to Baksojor
Baksojor collected $0.12 from pot
Baksojor: doesn't show hand
*** SUMMARY ***
Total pot $0.12 | Rake $0
Seat 1: IldarD86 (button) folded before Flop (didn't bet)
Seat 2: BigBoyStakes (small blind) folded before Flop
Seat 3: disident365 (big blind) folded before Flop
Seat 4: OMG DerClown folded before Flop (didn't bet)
Seat 5: qk rodriguez folded before Flop (didn't bet)
Seat 6: Baksojor collected ($0.12)


*********** # 200 **************
PokerStars Zoom Hand #174047153548:  Hold'em No Limit ($0.02/$0.05) - 2017/08/07 23:07:09 MSK [2017/08/07 16:07:09 ET]
Table 'Donati' 6-max Seat #1 is the button
Seat 1: ppyoda ($5 in chips)
Seat 2: Baksojor ($5.21 in chips)
Seat 3: LloydBanksss ($6.94 in chips)
Seat 4: Yahan588 ($5 in chips)
Seat 5: JennaTILTson ($19.85 in chips)
Seat 6: AlberTSifon ($5 in chips)
Baksojor: posts small blind $0.02
LloydBanksss: posts big blind $0.05
*** HOLE CARDS ***
Dealt to Baksojor [Kc 6d]
Yahan588: folds
JennaTILTson: folds
AlberTSifon: raises $0.10 to $0.15
ppyoda: folds
Baksojor: folds
LloydBanksss: calls $0.10
*** FLOP *** [Jh 9h 3h]
LloydBanksss: checks
AlberTSifon: checks
*** TURN *** [Jh 9h 3h] [2s]
LloydBanksss: checks
AlberTSifon: checks
*** RIVER *** [Jh 9h 3h 2s] [Ts]
LloydBanksss: checks
AlberTSifon: checks
*** SHOW DOWN ***
LloydBanksss: shows [8d 9c] (a pair of Nines)
AlberTSifon: mucks hand
LloydBanksss collected $0.31 from pot
*** SUMMARY ***
Total pot $0.32 | Rake $0.01
Board [Jh 9h 3h 2s Ts]
Seat 1: ppyoda (button) folded before Flop (didn't bet)
Seat 2: Baksojor (small blind) folded before Flop
Seat 3: LloydBanksss (big blind) showed [8d 9c] and won ($0.31) with a pair of Nines
Seat 4: Yahan588 folded before Flop (didn't bet)
Seat 5: JennaTILTson folded before Flop (didn't bet)
Seat 6: AlberTSifon mucked [Ac Kd]
