*********** # 1 **************
PokerStars Zoom Hand #174065933321:  Hold'em No Limit ($0.02/$0.05) - 2017/08/08 11:18:36 MSK [2017/08/08 4:18:36 ET]
Table 'Donati' 6-max Seat #1 is the button
Seat 1: arturs86 ($2.64 in chips)
Seat 2: xerrorPL ($5.35 in chips)
Seat 3: Baksojor ($5.60 in chips)
Seat 4: 0xC0DEBEEF ($5 in chips)
Seat 5: j18010030 ($5.02 in chips)
Seat 6: zazaz1977 ($5.35 in chips)
xerrorPL: posts small blind $0.02
Baksojor: posts big blind $0.05
*** HOLE CARDS ***
Dealt to Baksojor [Kd Td]
0xC0DEBEEF: folds
j18010030: raises $0.10 to $0.15
zazaz1977: folds
arturs86: folds
xerrorPL: folds
Baksojor: folds
Uncalled bet ($0.10) returned to j18010030
j18010030 collected $0.12 from pot
j18010030: doesn't show hand
*** SUMMARY ***
Total pot $0.12 | Rake $0
Seat 1: arturs86 (button) folded before Flop (didn't bet)
Seat 2: xerrorPL (small blind) folded before Flop
Seat 3: Baksojor (big blind) folded before Flop
Seat 4: 0xC0DEBEEF folded before Flop (didn't bet)
Seat 5: j18010030 collected ($0.12)
Seat 6: zazaz1977 folded before Flop (didn't bet)


*********** # 2 **************
PokerStars Zoom Hand #174065926586:  Hold'em No Limit ($0.02/$0.05) - 2017/08/08 11:18:13 MSK [2017/08/08 4:18:13 ET]
Table 'Donati' 6-max Seat #1 is the button
Seat 1: antonis1988 ($5 in chips)
Seat 2: Baksojor ($5.62 in chips)
Seat 3: 3iourou ($10.02 in chips)
Seat 4: j18010030 ($5.09 in chips)
Seat 5: merfol ($4.47 in chips)
Seat 6: davay300 ($11.96 in chips)
Baksojor: posts small blind $0.02
3iourou: posts big blind $0.05
*** HOLE CARDS ***
Dealt to Baksojor [4c 6c]
j18010030: folds
merfol: raises $0.07 to $0.12
davay300: folds
antonis1988: folds
Baksojor: folds
3iourou: folds
Uncalled bet ($0.07) returned to merfol
merfol collected $0.12 from pot
merfol: doesn't show hand
*** SUMMARY ***
Total pot $0.12 | Rake $0
Seat 1: antonis1988 (button) folded before Flop (didn't bet)
Seat 2: Baksojor (small blind) folded before Flop
Seat 3: 3iourou (big blind) folded before Flop
Seat 4: j18010030 folded before Flop (didn't bet)
Seat 5: merfol collected ($0.12)
Seat 6: davay300 folded before Flop (didn't bet)


*********** # 3 **************
PokerStars Zoom Hand #174065921408:  Hold'em No Limit ($0.02/$0.05) - 2017/08/08 11:17:55 MSK [2017/08/08 4:17:55 ET]
Table 'Donati' 6-max Seat #1 is the button
Seat 1: Baksojor ($5.55 in chips)
Seat 2: Luettefee ($4.96 in chips)
Seat 3: Nikk185 ($3.40 in chips)
Seat 4: BigBangVzla ($6.60 in chips)
Seat 5: zen approach ($8.43 in chips)
Seat 6: edik111666 ($7.85 in chips)
Luettefee: posts small blind $0.02
Nikk185: posts big blind $0.05
*** HOLE CARDS ***
Dealt to Baksojor [6s Tc]
BigBangVzla: folds
zen approach: folds
edik111666: folds
Baksojor: raises $0.05 to $0.10
Luettefee: folds
Nikk185: folds
Uncalled bet ($0.05) returned to Baksojor
Baksojor collected $0.12 from pot
Baksojor: doesn't show hand
*** SUMMARY ***
Total pot $0.12 | Rake $0
Seat 1: Baksojor (button) collected ($0.12)
Seat 2: Luettefee (small blind) folded before Flop
Seat 3: Nikk185 (big blind) folded before Flop
Seat 4: BigBangVzla folded before Flop (didn't bet)
Seat 5: zen approach folded before Flop (didn't bet)
Seat 6: edik111666 folded before Flop (didn't bet)


*********** # 4 **************
PokerStars Zoom Hand #174065917132:  Hold'em No Limit ($0.02/$0.05) - 2017/08/08 11:17:40 MSK [2017/08/08 4:17:40 ET]
Table 'Donati' 6-max Seat #1 is the button
Seat 1: Stray Jack ($5.31 in chips)
Seat 2: Eyrena ($5.35 in chips)
Seat 3: edi_jos_amos ($6.55 in chips)
Seat 4: Shootnick88 ($5.19 in chips)
Seat 5: Baksojor ($5.55 in chips)
Seat 6: Cartman 8703 ($6.43 in chips)
Eyrena: posts small blind $0.02
edi_jos_amos: posts big blind $0.05
*** HOLE CARDS ***
Dealt to Baksojor [8c 2d]
Shootnick88: folds
Baksojor: folds
Cartman 8703: folds
Stray Jack: folds
Eyrena: raises $0.05 to $0.10
edi_jos_amos: folds
Uncalled bet ($0.05) returned to Eyrena
Eyrena collected $0.10 from pot
Eyrena: doesn't show hand
*** SUMMARY ***
Total pot $0.10 | Rake $0
Seat 1: Stray Jack (button) folded before Flop (didn't bet)
Seat 2: Eyrena (small blind) collected ($0.10)
Seat 3: edi_jos_amos (big blind) folded before Flop
Seat 4: Shootnick88 folded before Flop (didn't bet)
Seat 5: Baksojor folded before Flop (didn't bet)
Seat 6: Cartman 8703 folded before Flop (didn't bet)


*********** # 5 **************
PokerStars Zoom Hand #174065915101:  Hold'em No Limit ($0.02/$0.05) - 2017/08/08 11:17:33 MSK [2017/08/08 4:17:33 ET]
Table 'Donati' 6-max Seat #1 is the button
Seat 1: MutbKa01 ($5.27 in chips)
Seat 2: romanshepp ($5.53 in chips)
Seat 3: Montserrigo ($4.88 in chips)
Seat 4: Avazenzuk ($1.46 in chips)
Seat 5: DINORIJEKA ($4.16 in chips)
Seat 6: Baksojor ($5.55 in chips)
romanshepp: posts small blind $0.02
Montserrigo: posts big blind $0.05
*** HOLE CARDS ***
Dealt to Baksojor [Ks 4h]
Avazenzuk: raises $0.10 to $0.15
DINORIJEKA: folds
Baksojor: folds
MutbKa01: folds
romanshepp: folds
Montserrigo: calls $0.10
*** FLOP *** [Qc 9h As]
Montserrigo: checks
Avazenzuk: bets $0.15
Montserrigo: calls $0.15
*** TURN *** [Qc 9h As] [Th]
Montserrigo: checks
Avazenzuk: bets $0.60
Montserrigo: folds
Uncalled bet ($0.60) returned to Avazenzuk
Avazenzuk collected $0.59 from pot
Avazenzuk: doesn't show hand
*** SUMMARY ***
Total pot $0.62 | Rake $0.03
Board [Qc 9h As Th]
Seat 1: MutbKa01 (button) folded before Flop (didn't bet)
Seat 2: romanshepp (small blind) folded before Flop
Seat 3: Montserrigo (big blind) folded on the Turn
Seat 4: Avazenzuk collected ($0.59)
Seat 5: DINORIJEKA folded before Flop (didn't bet)
Seat 6: Baksojor folded before Flop (didn't bet)


*********** # 6 **************
PokerStars Zoom Hand #174065912594:  Hold'em No Limit ($0.02/$0.05) - 2017/08/08 11:17:24 MSK [2017/08/08 4:17:24 ET]
Table 'Donati' 6-max Seat #1 is the button
Seat 1: zen approach ($8.48 in chips)
Seat 2: Brentyyy ($14.32 in chips)
Seat 3: Baksojor ($5.53 in chips)
Seat 4: MayaPattaya ($5 in chips)
Seat 5: simple s0o ($9.38 in chips)
Seat 6: Lasutchik ($3.93 in chips)
Brentyyy: posts small blind $0.02
Baksojor: posts big blind $0.05
*** HOLE CARDS ***
Dealt to Baksojor [9c 3s]
MayaPattaya: folds
simple s0o: folds
Lasutchik: folds
zen approach: folds
Brentyyy: folds
Uncalled bet ($0.03) returned to Baksojor
Baksojor collected $0.04 from pot
Baksojor: doesn't show hand
*** SUMMARY ***
Total pot $0.04 | Rake $0
Seat 1: zen approach (button) folded before Flop (didn't bet)
Seat 2: Brentyyy (small blind) folded before Flop
Seat 3: Baksojor (big blind) collected ($0.04)
Seat 4: MayaPattaya folded before Flop (didn't bet)
Seat 5: simple s0o folded before Flop (didn't bet)
Seat 6: Lasutchik folded before Flop (didn't bet)


*********** # 7 **************
PokerStars Zoom Hand #174065906023:  Hold'em No Limit ($0.02/$0.05) - 2017/08/08 11:17:01 MSK [2017/08/08 4:17:01 ET]
Table 'Donati' 6-max Seat #1 is the button
Seat 1: Baksojor ($5.46 in chips)
Seat 2: subagyuri ($1.14 in chips)
Seat 3: Lasutchik ($6.13 in chips)
Seat 4: sportivnii ($13.35 in chips)
Seat 5: Brentyyy ($22.89 in chips)
Seat 6: ChadAtIt ($5.36 in chips)
subagyuri: posts small blind $0.02
Lasutchik: posts big blind $0.05
*** HOLE CARDS ***
Dealt to Baksojor [7d 5h]
sportivnii: folds
Brentyyy: folds
ChadAtIt: folds
Baksojor: raises $0.05 to $0.10
subagyuri: folds
Lasutchik: folds
Uncalled bet ($0.05) returned to Baksojor
Baksojor collected $0.12 from pot
Baksojor: doesn't show hand
*** SUMMARY ***
Total pot $0.12 | Rake $0
Seat 1: Baksojor (button) collected ($0.12)
Seat 2: subagyuri (small blind) folded before Flop
Seat 3: Lasutchik (big blind) folded before Flop
Seat 4: sportivnii folded before Flop (didn't bet)
Seat 5: Brentyyy folded before Flop (didn't bet)
Seat 6: ChadAtIt folded before Flop (didn't bet)


*********** # 8 **************
PokerStars Zoom Hand #174065904267:  Hold'em No Limit ($0.02/$0.05) - 2017/08/08 11:16:55 MSK [2017/08/08 4:16:55 ET]
Table 'Donati' 6-max Seat #1 is the button
Seat 1: MResetM ($5.08 in chips)
Seat 2: Baksojor ($5.48 in chips)
Seat 3: IGROK101 ($5.44 in chips)
Seat 4: Lessotto ($5.57 in chips)
Seat 5: jimpoker1997 ($5.16 in chips)
Seat 6: Nidhogg25 ($5 in chips)
Baksojor: posts small blind $0.02
IGROK101: posts big blind $0.05
*** HOLE CARDS ***
Dealt to Baksojor [2s Jc]
Lessotto: folds
jimpoker1997: folds
Nidhogg25: folds
MResetM: raises $0.10 to $0.15
Baksojor: folds
IGROK101: folds
Uncalled bet ($0.10) returned to MResetM
MResetM collected $0.12 from pot
MResetM: doesn't show hand
*** SUMMARY ***
Total pot $0.12 | Rake $0
Seat 1: MResetM (button) collected ($0.12)
Seat 2: Baksojor (small blind) folded before Flop
Seat 3: IGROK101 (big blind) folded before Flop
Seat 4: Lessotto folded before Flop (didn't bet)
Seat 5: jimpoker1997 folded before Flop (didn't bet)
Seat 6: Nidhogg25 folded before Flop (didn't bet)


*********** # 9 **************
PokerStars Zoom Hand #174065902849:  Hold'em No Limit ($0.02/$0.05) - 2017/08/08 11:16:50 MSK [2017/08/08 4:16:50 ET]
Table 'Donati' 6-max Seat #1 is the button
Seat 1: RiVeRBeLoW98 ($13.92 in chips)
Seat 2: 0xC0DEBEEF ($10.27 in chips)
Seat 3: melodrama3 ($6.41 in chips)
Seat 4: Baksojor ($5.48 in chips)
Seat 5: Lessotto ($5 in chips)
Seat 6: simple s0o ($7.40 in chips)
0xC0DEBEEF: posts small blind $0.02
melodrama3: posts big blind $0.05
*** HOLE CARDS ***
Dealt to Baksojor [3h 4c]
Baksojor: folds
Lessotto: folds
simple s0o: folds
RiVeRBeLoW98: raises $0.07 to $0.12
0xC0DEBEEF: raises $0.29 to $0.41
melodrama3: folds
RiVeRBeLoW98: calls $0.29
*** FLOP *** [9d 9c 9s]
0xC0DEBEEF: checks
RiVeRBeLoW98: checks
*** TURN *** [9d 9c 9s] [2d]
0xC0DEBEEF: bets $0.10
RiVeRBeLoW98: calls $0.10
*** RIVER *** [9d 9c 9s 2d] [8s]
0xC0DEBEEF: bets $0.05
RiVeRBeLoW98: calls $0.05
*** SHOW DOWN ***
0xC0DEBEEF: shows [7h 7d] (a full house, Nines full of Sevens)
RiVeRBeLoW98: mucks hand
0xC0DEBEEF collected $1.12 from pot
*** SUMMARY ***
Total pot $1.17 | Rake $0.05
Board [9d 9c 9s 2d 8s]
Seat 1: RiVeRBeLoW98 (button) mucked [Ah 2h]
Seat 2: 0xC0DEBEEF (small blind) showed [7h 7d] and won ($1.12) with a full house, Nines full of Sevens
Seat 3: melodrama3 (big blind) folded before Flop
Seat 4: Baksojor folded before Flop (didn't bet)
Seat 5: Lessotto folded before Flop (didn't bet)
Seat 6: simple s0o folded before Flop (didn't bet)


*********** # 10 **************
PokerStars Zoom Hand #174065879502:  Hold'em No Limit ($0.02/$0.05) - 2017/08/08 11:15:29 MSK [2017/08/08 4:15:29 ET]
Table 'Donati' 6-max Seat #1 is the button
Seat 1: antoxa oz ($6.22 in chips)
Seat 2: honeyjon ($7.55 in chips)
Seat 3: kingomanu ($5.15 in chips)
Seat 4: melodrama3 ($5.23 in chips)
Seat 5: Baksojor ($5 in chips)
Seat 6: NISIY ($5 in chips)
honeyjon: posts small blind $0.02
kingomanu: posts big blind $0.05
*** HOLE CARDS ***
Dealt to Baksojor [Ac 3c]
melodrama3: folds
Baksojor: raises $0.10 to $0.15
NISIY: raises $0.30 to $0.45
antoxa oz: folds
honeyjon: folds
kingomanu: folds
Baksojor: calls $0.30
*** FLOP *** [Kc Jc 3h]
Baksojor: checks
NISIY: checks
*** TURN *** [Kc Jc 3h] [Ah]
Baksojor: bets $0.95
NISIY: folds
Uncalled bet ($0.95) returned to Baksojor
Baksojor collected $0.93 from pot
Baksojor: doesn't show hand
*** SUMMARY ***
Total pot $0.97 | Rake $0.04
Board [Kc Jc 3h Ah]
Seat 1: antoxa oz (button) folded before Flop (didn't bet)
Seat 2: honeyjon (small blind) folded before Flop
Seat 3: kingomanu (big blind) folded before Flop
Seat 4: melodrama3 folded before Flop (didn't bet)
Seat 5: Baksojor collected ($0.93)
Seat 6: NISIY folded on the Turn


*********** # 11 **************
PokerStars Zoom Hand #174065878034:  Hold'em No Limit ($0.02/$0.05) - 2017/08/08 11:15:24 MSK [2017/08/08 4:15:24 ET]
Table 'Donati' 6-max Seat #1 is the button
Seat 1: jimpoker1997 ($8.63 in chips)
Seat 2: judy2222 ($5.92 in chips)
Seat 3: LaMahiala ($9.28 in chips)
Seat 4: XBlackDog81 ($3.82 in chips)
Seat 5: Baksojor ($5 in chips)
Seat 6: funtik00001 ($10.35 in chips)
judy2222: posts small blind $0.02
LaMahiala: posts big blind $0.05
*** HOLE CARDS ***
Dealt to Baksojor [2d Qh]
XBlackDog81: raises $0.10 to $0.15
Baksojor: folds
funtik00001: folds
jimpoker1997: folds
judy2222: folds
LaMahiala: calls $0.10
*** FLOP *** [Th Ac 4h]
LaMahiala: checks
XBlackDog81: bets $0.16
LaMahiala: raises $0.26 to $0.42
XBlackDog81: folds
Uncalled bet ($0.26) returned to LaMahiala
LaMahiala collected $0.61 from pot
LaMahiala: doesn't show hand
*** SUMMARY ***
Total pot $0.64 | Rake $0.03
Board [Th Ac 4h]
Seat 1: jimpoker1997 (button) folded before Flop (didn't bet)
Seat 2: judy2222 (small blind) folded before Flop
Seat 3: LaMahiala (big blind) collected ($0.61)
Seat 4: XBlackDog81 folded on the Flop
Seat 5: Baksojor folded before Flop (didn't bet)
Seat 6: funtik00001 folded before Flop (didn't bet)


*********** # 12 **************
PokerStars Zoom Hand #174065873760:  Hold'em No Limit ($0.02/$0.05) - 2017/08/08 11:15:09 MSK [2017/08/08 4:15:09 ET]
Table 'Donati' 6-max Seat #1 is the button
Seat 1: king778899 ($7.33 in chips)
Seat 2: zen approach ($8.93 in chips)
Seat 3: Baksojor ($5 in chips)
Seat 4: HighRaider ($5.57 in chips)
Seat 5: goopy2307 ($3.29 in chips)
Seat 6: JIuMuHTa ($6.18 in chips)
zen approach: posts small blind $0.02
Baksojor: posts big blind $0.05
*** HOLE CARDS ***
Dealt to Baksojor [Ad 4s]
HighRaider: raises $0.07 to $0.12
goopy2307: folds
JIuMuHTa: folds
king778899: calls $0.12
zen approach: folds
Baksojor: folds
*** FLOP *** [6h 3c 7s]
HighRaider: bets $0.23
king778899: folds
Uncalled bet ($0.23) returned to HighRaider
HighRaider collected $0.30 from pot
HighRaider: doesn't show hand
*** SUMMARY ***
Total pot $0.31 | Rake $0.01
Board [6h 3c 7s]
Seat 1: king778899 (button) folded on the Flop
Seat 2: zen approach (small blind) folded before Flop
Seat 3: Baksojor (big blind) folded before Flop
Seat 4: HighRaider collected ($0.30)
Seat 5: goopy2307 folded before Flop (didn't bet)
Seat 6: JIuMuHTa folded before Flop (didn't bet)


*********** # 13 **************
PokerStars Zoom Hand #174065870244:  Hold'em No Limit ($0.02/$0.05) - 2017/08/08 11:14:57 MSK [2017/08/08 4:14:57 ET]
Table 'Donati' 6-max Seat #1 is the button
Seat 1: ilsol ($6.17 in chips)
Seat 2: pipecmolodec ($5.19 in chips)
Seat 3: ARVIZUX ($5 in chips)
Seat 4: DAKSo ($5.81 in chips)
Seat 5: ChadAtIt ($5.22 in chips)
Seat 6: Baksojor ($5 in chips)
pipecmolodec: posts small blind $0.02
ARVIZUX: posts big blind $0.05
*** HOLE CARDS ***
Dealt to Baksojor [5d 6s]
DAKSo: folds
ChadAtIt: folds
Baksojor: folds
ilsol: folds
pipecmolodec: raises $0.07 to $0.12
ARVIZUX: folds
Uncalled bet ($0.07) returned to pipecmolodec
pipecmolodec collected $0.10 from pot
pipecmolodec: doesn't show hand
*** SUMMARY ***
Total pot $0.10 | Rake $0
Seat 1: ilsol (button) folded before Flop (didn't bet)
Seat 2: pipecmolodec (small blind) collected ($0.10)
Seat 3: ARVIZUX (big blind) folded before Flop
Seat 4: DAKSo folded before Flop (didn't bet)
Seat 5: ChadAtIt folded before Flop (didn't bet)
Seat 6: Baksojor folded before Flop (didn't bet)


*********** # 14 **************
PokerStars Zoom Hand #174065860048:  Hold'em No Limit ($0.02/$0.05) - 2017/08/08 11:14:21 MSK [2017/08/08 4:14:21 ET]
Table 'Donati' 6-max Seat #1 is the button
Seat 1: Baksojor ($5 in chips)
Seat 2: Avtor(RUS) ($5.28 in chips)
Seat 3: asdeadsa ($8.10 in chips)
Seat 4: IRA217 ($4.82 in chips)
Seat 5: paziTka_kdL ($5.37 in chips)
Seat 6: Mark141278 ($2.21 in chips)
Avtor(RUS): posts small blind $0.02
asdeadsa: posts big blind $0.05
*** HOLE CARDS ***
Dealt to Baksojor [7d 5c]
IRA217: raises $0.10 to $0.15
paziTka_kdL: folds
Mark141278 has timed out
Mark141278: folds
Baksojor: folds
Avtor(RUS): folds
asdeadsa: folds
Uncalled bet ($0.10) returned to IRA217
IRA217 collected $0.12 from pot
IRA217: doesn't show hand
*** SUMMARY ***
Total pot $0.12 | Rake $0
Seat 1: Baksojor (button) folded before Flop (didn't bet)
Seat 2: Avtor(RUS) (small blind) folded before Flop
Seat 3: asdeadsa (big blind) folded before Flop
Seat 4: IRA217 collected ($0.12)
Seat 5: paziTka_kdL folded before Flop (didn't bet)
Seat 6: Mark141278 folded before Flop (didn't bet)


*********** # 15 **************
PokerStars Zoom Hand #174065858939:  Hold'em No Limit ($0.02/$0.05) - 2017/08/08 11:14:17 MSK [2017/08/08 4:14:17 ET]
Table 'Donati' 6-max Seat #1 is the button
Seat 1: olig@rchic ($3.13 in chips)
Seat 2: jimpoker1997 ($5 in chips)
Seat 3: goopy2307 ($3.09 in chips)
Seat 4: Baksojor ($5 in chips)
Seat 5: Mark141278 ($2.21 in chips)
Seat 6: pokers7778 ($0.48 in chips)
jimpoker1997: posts small blind $0.02
goopy2307: posts big blind $0.05
*** HOLE CARDS ***
Dealt to Baksojor [5c 3h]
Baksojor: folds
Mark141278: folds
pokers7778: folds
olig@rchic: folds
jimpoker1997: folds
Uncalled bet ($0.03) returned to goopy2307
goopy2307 collected $0.04 from pot
goopy2307: doesn't show hand
*** SUMMARY ***
Total pot $0.04 | Rake $0
Seat 1: olig@rchic (button) folded before Flop (didn't bet)
Seat 2: jimpoker1997 (small blind) folded before Flop
Seat 3: goopy2307 (big blind) collected ($0.04)
Seat 4: Baksojor folded before Flop (didn't bet)
Seat 5: Mark141278 folded before Flop (didn't bet)
Seat 6: pokers7778 folded before Flop (didn't bet)


*********** # 16 **************
PokerStars Zoom Hand #174065854947:  Hold'em No Limit ($0.02/$0.05) - 2017/08/08 11:14:03 MSK [2017/08/08 4:14:03 ET]
Table 'Donati' 6-max Seat #1 is the button
Seat 1: C_Hammer03 ($10.25 in chips)
Seat 2: Baksojor ($5 in chips)
Seat 3: GetRhythm1 ($5 in chips)
Seat 4: zen approach ($9.05 in chips)
Seat 5: funtik00001 ($10.99 in chips)
Seat 6: zazaz1977 ($5.07 in chips)
Baksojor: posts small blind $0.02
GetRhythm1: posts big blind $0.05
*** HOLE CARDS ***
Dealt to Baksojor [7c 4c]
zen approach: folds
funtik00001: folds
zazaz1977: raises $0.10 to $0.15
C_Hammer03: folds
Baksojor: folds
GetRhythm1: raises $0.35 to $0.50
zazaz1977: folds
Uncalled bet ($0.35) returned to GetRhythm1
GetRhythm1 collected $0.32 from pot
GetRhythm1: doesn't show hand
*** SUMMARY ***
Total pot $0.32 | Rake $0
Seat 1: C_Hammer03 (button) folded before Flop (didn't bet)
Seat 2: Baksojor (small blind) folded before Flop
Seat 3: GetRhythm1 (big blind) collected ($0.32)
Seat 4: zen approach folded before Flop (didn't bet)
Seat 5: funtik00001 folded before Flop (didn't bet)
Seat 6: zazaz1977 folded before Flop


*********** # 17 **************
PokerStars Zoom Hand #174065836187:  Hold'em No Limit ($0.02/$0.05) - 2017/08/08 11:12:57 MSK [2017/08/08 4:12:57 ET]
Table 'Donati' 6-max Seat #1 is the button
Seat 1: Baksojor ($5 in chips)
Seat 2: xerrorPL ($5.02 in chips)
Seat 3: Dexdor ($9.23 in chips)
Seat 4: AttilaHun79 ($6.71 in chips)
Seat 5: Eldoura ($5.14 in chips)
Seat 6: AANDD Flash ($5.49 in chips)
xerrorPL: posts small blind $0.02
Dexdor: posts big blind $0.05
*** HOLE CARDS ***
Dealt to Baksojor [6c Jd]
AttilaHun79: folds
Eldoura: folds
AANDD Flash: folds
Baksojor: raises $0.05 to $0.10
xerrorPL: folds
Dexdor: calls $0.05
*** FLOP *** [Qh Ad 4d]
Dexdor: checks
Baksojor: bets $0.12
Dexdor: calls $0.12
*** TURN *** [Qh Ad 4d] [8s]
Dexdor: checks
Baksojor: checks
*** RIVER *** [Qh Ad 4d 8s] [7c]
Dexdor: bets $0.18
Baksojor: folds
Uncalled bet ($0.18) returned to Dexdor
Dexdor collected $0.44 from pot
Dexdor: doesn't show hand
*** SUMMARY ***
Total pot $0.46 | Rake $0.02
Board [Qh Ad 4d 8s 7c]
Seat 1: Baksojor (button) folded on the River
Seat 2: xerrorPL (small blind) folded before Flop
Seat 3: Dexdor (big blind) collected ($0.44)
Seat 4: AttilaHun79 folded before Flop (didn't bet)
Seat 5: Eldoura folded before Flop (didn't bet)
Seat 6: AANDD Flash folded before Flop (didn't bet)


*********** # 18 **************
PokerStars Zoom Hand #174065803028:  Hold'em No Limit ($0.02/$0.05) - 2017/08/08 11:10:58 MSK [2017/08/08 4:10:58 ET]
Table 'Donati' 6-max Seat #1 is the button
Seat 1: orcaraptor ($6.91 in chips)
Seat 2: RiVeRBeLoW98 ($14.02 in chips)
Seat 3: sportivnii ($11.09 in chips)
Seat 4: XBlackDog81 ($4.81 in chips)
Seat 5: ser111375 ($5 in chips)
Seat 6: Baksojor ($5.18 in chips)
RiVeRBeLoW98: posts small blind $0.02
sportivnii: posts big blind $0.05
*** HOLE CARDS ***
Dealt to Baksojor [6s Ts]
XBlackDog81: folds
ser111375: folds
Baksojor: raises $0.07 to $0.12
orcaraptor: folds
RiVeRBeLoW98: raises $0.38 to $0.50
sportivnii: calls $0.45
Baksojor: calls $0.38
*** FLOP *** [4h Kd Ad]
RiVeRBeLoW98: checks
sportivnii: checks
Baksojor: checks
*** TURN *** [4h Kd Ad] [9s]
RiVeRBeLoW98: checks
sportivnii: checks
Baksojor: checks
*** RIVER *** [4h Kd Ad 9s] [3s]
RiVeRBeLoW98: bets $2.12
sportivnii: folds
Baksojor: folds
Uncalled bet ($2.12) returned to RiVeRBeLoW98
RiVeRBeLoW98 collected $1.44 from pot
RiVeRBeLoW98: doesn't show hand
*** SUMMARY ***
Total pot $1.50 | Rake $0.06
Board [4h Kd Ad 9s 3s]
Seat 1: orcaraptor (button) folded before Flop (didn't bet)
Seat 2: RiVeRBeLoW98 (small blind) collected ($1.44)
Seat 3: sportivnii (big blind) folded on the River
Seat 4: XBlackDog81 folded before Flop (didn't bet)
Seat 5: ser111375 folded before Flop (didn't bet)
Seat 6: Baksojor folded on the River


*********** # 19 **************
PokerStars Zoom Hand #174065783705:  Hold'em No Limit ($0.02/$0.05) - 2017/08/08 11:09:49 MSK [2017/08/08 4:09:49 ET]
Table 'Donati' 6-max Seat #1 is the button
Seat 1: kuzima_ge ($6.44 in chips)
Seat 2: ser111375 ($5.38 in chips)
Seat 3: Baksojor ($6.70 in chips)
Seat 4: sportivnii ($14.57 in chips)
Seat 5: Lasutchik ($4.39 in chips)
Seat 6: joekor00 ($12.57 in chips)
ser111375: posts small blind $0.02
Baksojor: posts big blind $0.05
*** HOLE CARDS ***
Dealt to Baksojor [Qc Ac]
sportivnii: folds
Lasutchik: folds
joekor00: folds
kuzima_ge: raises $0.07 to $0.12
ser111375: folds
Baksojor: raises $0.38 to $0.50
kuzima_ge: raises $1.02 to $1.52
Baksojor: calls $1.02
*** FLOP *** [7h 9d 6d]
Baksojor: checks
kuzima_ge: checks
*** TURN *** [7h 9d 6d] [Jd]
Baksojor: checks
kuzima_ge: checks
*** RIVER *** [7h 9d 6d Jd] [Th]
Baksojor: checks
kuzima_ge: bets $1.47
Baksojor: folds
Uncalled bet ($1.47) returned to kuzima_ge
kuzima_ge collected $2.93 from pot
kuzima_ge: doesn't show hand
*** SUMMARY ***
Total pot $3.06 | Rake $0.13
Board [7h 9d 6d Jd Th]
Seat 1: kuzima_ge (button) collected ($2.93)
Seat 2: ser111375 (small blind) folded before Flop
Seat 3: Baksojor (big blind) folded on the River
Seat 4: sportivnii folded before Flop (didn't bet)
Seat 5: Lasutchik folded before Flop (didn't bet)
Seat 6: joekor00 folded before Flop (didn't bet)


*********** # 20 **************
PokerStars Zoom Hand #174065782507:  Hold'em No Limit ($0.02/$0.05) - 2017/08/08 11:09:45 MSK [2017/08/08 4:09:45 ET]
Table 'Donati' 6-max Seat #1 is the button
Seat 1: melodrama3 ($5.21 in chips)
Seat 2: IGOR1957 ($9.12 in chips)
Seat 3: 3iourou ($7.84 in chips)
Seat 4: Baksojor ($6.70 in chips)
Seat 5: RiVeRBeLoW98 ($14.78 in chips)
Seat 6: SquirtleSquad ($5 in chips)
IGOR1957: posts small blind $0.02
3iourou: posts big blind $0.05
*** HOLE CARDS ***
Dealt to Baksojor [Jh 8s]
Baksojor: folds
RiVeRBeLoW98: folds
SquirtleSquad: folds
melodrama3: folds
IGOR1957: raises $0.05 to $0.10
3iourou: calls $0.05
*** FLOP *** [9c 2h Jd]
IGOR1957: checks
3iourou: bets $0.06
IGOR1957: calls $0.06
*** TURN *** [9c 2h Jd] [5d]
IGOR1957: checks
3iourou: checks
*** RIVER *** [9c 2h Jd 5d] [4c]
IGOR1957: checks
3iourou: bets $0.35
IGOR1957: calls $0.35
*** SHOW DOWN ***
3iourou: shows [Ks Jc] (a pair of Jacks)
IGOR1957: mucks hand
3iourou collected $0.98 from pot
*** SUMMARY ***
Total pot $1.02 | Rake $0.04
Board [9c 2h Jd 5d 4c]
Seat 1: melodrama3 (button) folded before Flop (didn't bet)
Seat 2: IGOR1957 (small blind) mucked [9d Ad]
Seat 3: 3iourou (big blind) showed [Ks Jc] and won ($0.98) with a pair of Jacks
Seat 4: Baksojor folded before Flop (didn't bet)
Seat 5: RiVeRBeLoW98 folded before Flop (didn't bet)
Seat 6: SquirtleSquad folded before Flop (didn't bet)


*********** # 21 **************
PokerStars Zoom Hand #174065781089:  Hold'em No Limit ($0.02/$0.05) - 2017/08/08 11:09:40 MSK [2017/08/08 4:09:40 ET]
Table 'Donati' 6-max Seat #1 is the button
Seat 1: davay300 ($5 in chips)
Seat 2: Baksojor ($6.72 in chips)
Seat 3: MaxDVS ($9.45 in chips)
Seat 4: MResetM ($6.03 in chips)
Seat 5: Culiacan448 ($9.31 in chips)
Seat 6: kuzima_ge ($5.83 in chips)
Baksojor: posts small blind $0.02
MaxDVS: posts big blind $0.05
*** HOLE CARDS ***
Dealt to Baksojor [6s 3s]
MResetM: folds
Culiacan448: raises $0.07 to $0.12
kuzima_ge: folds
davay300: folds
Baksojor: folds
MaxDVS: folds
Uncalled bet ($0.07) returned to Culiacan448
Culiacan448 collected $0.12 from pot
Culiacan448: doesn't show hand
*** SUMMARY ***
Total pot $0.12 | Rake $0
Seat 1: davay300 (button) folded before Flop (didn't bet)
Seat 2: Baksojor (small blind) folded before Flop
Seat 3: MaxDVS (big blind) folded before Flop
Seat 4: MResetM folded before Flop (didn't bet)
Seat 5: Culiacan448 collected ($0.12)
Seat 6: kuzima_ge folded before Flop (didn't bet)


*********** # 22 **************
PokerStars Zoom Hand #174065779414:  Hold'em No Limit ($0.02/$0.05) - 2017/08/08 11:09:34 MSK [2017/08/08 4:09:34 ET]
Table 'Donati' 6-max Seat #1 is the button
Seat 1: HighRaider ($5.10 in chips)
Seat 2: antonis1988 ($22.19 in chips)
Seat 3: pehtaras22 ($6.94 in chips)
Seat 4: Baksojor ($6.72 in chips)
Seat 5: play4fun424 ($1.81 in chips)
Seat 6: taketwice ($4.53 in chips)
antonis1988: posts small blind $0.02
pehtaras22: posts big blind $0.05
*** HOLE CARDS ***
Dealt to Baksojor [5d 6d]
Baksojor: folds
play4fun424: folds
taketwice: calls $0.05
HighRaider: folds
antonis1988: folds
pehtaras22: checks
*** FLOP *** [Jc 4h Qh]
pehtaras22: checks
taketwice: bets $0.10
pehtaras22: folds
Uncalled bet ($0.10) returned to taketwice
taketwice collected $0.12 from pot
taketwice: doesn't show hand
*** SUMMARY ***
Total pot $0.12 | Rake $0
Board [Jc 4h Qh]
Seat 1: HighRaider (button) folded before Flop (didn't bet)
Seat 2: antonis1988 (small blind) folded before Flop
Seat 3: pehtaras22 (big blind) folded on the Flop
Seat 4: Baksojor folded before Flop (didn't bet)
Seat 5: play4fun424 folded before Flop (didn't bet)
Seat 6: taketwice collected ($0.12)


*********** # 23 **************
PokerStars Zoom Hand #174065778037:  Hold'em No Limit ($0.02/$0.05) - 2017/08/08 11:09:29 MSK [2017/08/08 4:09:29 ET]
Table 'Donati' 6-max Seat #1 is the button
Seat 1: 1firstbase1 ($5 in chips)
Seat 2: hiebsch87 ($5.02 in chips)
Seat 3: TeddyTaiwan ($5.07 in chips)
Seat 4: kita8444 ($11.36 in chips)
Seat 5: Pashattwild ($4.93 in chips)
Seat 6: Baksojor ($6.72 in chips)
hiebsch87: posts small blind $0.02
TeddyTaiwan: posts big blind $0.05
*** HOLE CARDS ***
Dealt to Baksojor [8h Qs]
kita8444: folds
Pashattwild: folds
Baksojor: folds
1firstbase1: raises $0.06 to $0.11
hiebsch87: folds
TeddyTaiwan: folds
Uncalled bet ($0.06) returned to 1firstbase1
1firstbase1 collected $0.12 from pot
1firstbase1: doesn't show hand
*** SUMMARY ***
Total pot $0.12 | Rake $0
Seat 1: 1firstbase1 (button) collected ($0.12)
Seat 2: hiebsch87 (small blind) folded before Flop
Seat 3: TeddyTaiwan (big blind) folded before Flop
Seat 4: kita8444 folded before Flop (didn't bet)
Seat 5: Pashattwild folded before Flop (didn't bet)
Seat 6: Baksojor folded before Flop (didn't bet)


*********** # 24 **************
PokerStars Zoom Hand #174065764474:  Hold'em No Limit ($0.02/$0.05) - 2017/08/08 11:08:41 MSK [2017/08/08 4:08:41 ET]
Table 'Donati' 6-max Seat #1 is the button
Seat 1: SquirtleSquad ($6.87 in chips)
Seat 2: Brentyyy ($5.53 in chips)
Seat 3: Baksojor ($6.24 in chips)
Seat 4: Yonny7777 ($7.31 in chips)
Seat 5: Dexdor ($5.47 in chips)
Seat 6: Astour194 ($7.09 in chips)
Brentyyy: posts small blind $0.02
Baksojor: posts big blind $0.05
*** HOLE CARDS ***
Dealt to Baksojor [Qd Ac]
Yonny7777: folds
Dexdor: folds
Astour194: raises $0.08 to $0.13
SquirtleSquad: folds
Brentyyy: folds
Baksojor: raises $0.37 to $0.50
Astour194: calls $0.37
*** FLOP *** [7s Td 8h]
Baksojor: bets $0.55
Astour194: folds
Uncalled bet ($0.55) returned to Baksojor
Baksojor collected $0.98 from pot
Baksojor: doesn't show hand
*** SUMMARY ***
Total pot $1.02 | Rake $0.04
Board [7s Td 8h]
Seat 1: SquirtleSquad (button) folded before Flop (didn't bet)
Seat 2: Brentyyy (small blind) folded before Flop
Seat 3: Baksojor (big blind) collected ($0.98)
Seat 4: Yonny7777 folded before Flop (didn't bet)
Seat 5: Dexdor folded before Flop (didn't bet)
Seat 6: Astour194 folded on the Flop


*********** # 25 **************
PokerStars Zoom Hand #174065760886:  Hold'em No Limit ($0.02/$0.05) - 2017/08/08 11:08:28 MSK [2017/08/08 4:08:28 ET]
Table 'Donati' 6-max Seat #1 is the button
Seat 1: LaMahiala ($7.18 in chips)
Seat 2: Lessotto ($5 in chips)
Seat 3: IRiverBluff ($6.01 in chips)
Seat 4: freekidwei ($6.42 in chips)
Seat 5: Baksojor ($6.24 in chips)
Seat 6: Yonny7777 ($7.33 in chips)
Lessotto: posts small blind $0.02
IRiverBluff: posts big blind $0.05
*** HOLE CARDS ***
Dealt to Baksojor [As 2d]
freekidwei: folds
Baksojor: folds
Yonny7777: folds
LaMahiala: raises $0.10 to $0.15
Lessotto: folds
IRiverBluff: calls $0.10
*** FLOP *** [Jh 8s 9h]
IRiverBluff: checks
LaMahiala: checks
*** TURN *** [Jh 8s 9h] [9s]
IRiverBluff: checks
LaMahiala: checks
*** RIVER *** [Jh 8s 9h 9s] [Kh]
IRiverBluff: checks
LaMahiala: checks
*** SHOW DOWN ***
IRiverBluff: shows [Ac Td] (a pair of Nines)
LaMahiala: shows [7s Ah] (a pair of Nines)
IRiverBluff collected $0.16 from pot
LaMahiala collected $0.15 from pot
*** SUMMARY ***
Total pot $0.32 | Rake $0.01
Board [Jh 8s 9h 9s Kh]
Seat 1: LaMahiala (button) showed [7s Ah] and won ($0.15) with a pair of Nines
Seat 2: Lessotto (small blind) folded before Flop
Seat 3: IRiverBluff (big blind) showed [Ac Td] and won ($0.16) with a pair of Nines
Seat 4: freekidwei folded before Flop (didn't bet)
Seat 5: Baksojor folded before Flop (didn't bet)
Seat 6: Yonny7777 folded before Flop (didn't bet)


*********** # 26 **************
PokerStars Zoom Hand #174065758335:  Hold'em No Limit ($0.02/$0.05) - 2017/08/08 11:08:19 MSK [2017/08/08 4:08:19 ET]
Table 'Donati' 6-max Seat #1 is the button
Seat 1: Lasutchik ($5.61 in chips)
Seat 2: kidvitis ($5.22 in chips)
Seat 3: nitzed12 ($5.12 in chips)
Seat 4: Baksojor ($6.24 in chips)
Seat 5: AUD137 ($9.06 in chips)
Seat 6: xerrorPL ($5.84 in chips)
kidvitis: posts small blind $0.02
nitzed12: posts big blind $0.05
*** HOLE CARDS ***
Dealt to Baksojor [4d Kd]
Baksojor: folds
AUD137: folds
xerrorPL: folds
Lasutchik: folds
kidvitis: calls $0.03
nitzed12: checks
*** FLOP *** [3d 6d 8d]
kidvitis: bets $0.05
nitzed12: folds
Uncalled bet ($0.05) returned to kidvitis
kidvitis collected $0.10 from pot
kidvitis: doesn't show hand
*** SUMMARY ***
Total pot $0.10 | Rake $0
Board [3d 6d 8d]
Seat 1: Lasutchik (button) folded before Flop (didn't bet)
Seat 2: kidvitis (small blind) collected ($0.10)
Seat 3: nitzed12 (big blind) folded on the Flop
Seat 4: Baksojor folded before Flop (didn't bet)
Seat 5: AUD137 folded before Flop (didn't bet)
Seat 6: xerrorPL folded before Flop (didn't bet)


*********** # 27 **************
PokerStars Zoom Hand #174065750988:  Hold'em No Limit ($0.02/$0.05) - 2017/08/08 11:07:53 MSK [2017/08/08 4:07:53 ET]
Table 'Donati' 6-max Seat #1 is the button
Seat 1: Baksojor ($6.17 in chips)
Seat 2: MResetM ($5.75 in chips)
Seat 3: JahSoldier69 ($5.13 in chips)
Seat 4: koshi712 ($8.19 in chips)
Seat 5: simple s0o ($5.16 in chips)
Seat 6: edik111666 ($5 in chips)
MResetM: posts small blind $0.02
JahSoldier69: posts big blind $0.05
*** HOLE CARDS ***
Dealt to Baksojor [8s 4d]
koshi712: folds
simple s0o: folds
edik111666: folds
Baksojor: raises $0.05 to $0.10
MResetM: folds
JahSoldier69: folds
Uncalled bet ($0.05) returned to Baksojor
Baksojor collected $0.12 from pot
Baksojor: doesn't show hand
*** SUMMARY ***
Total pot $0.12 | Rake $0
Seat 1: Baksojor (button) collected ($0.12)
Seat 2: MResetM (small blind) folded before Flop
Seat 3: JahSoldier69 (big blind) folded before Flop
Seat 4: koshi712 folded before Flop (didn't bet)
Seat 5: simple s0o folded before Flop (didn't bet)
Seat 6: edik111666 folded before Flop (didn't bet)


*********** # 28 **************
PokerStars Zoom Hand #174065749545:  Hold'em No Limit ($0.02/$0.05) - 2017/08/08 11:07:48 MSK [2017/08/08 4:07:48 ET]
Table 'Donati' 6-max Seat #1 is the button
Seat 1: Astour194 ($6.34 in chips)
Seat 2: bohdanovitch ($6.93 in chips)
Seat 3: pipecmolodec ($5 in chips)
Seat 4: Eldoura ($5 in chips)
Seat 5: Baksojor ($6.17 in chips)
Seat 6: thiusk ($5.63 in chips)
bohdanovitch: posts small blind $0.02
pipecmolodec: posts big blind $0.05
*** HOLE CARDS ***
Dealt to Baksojor [Qh 3s]
Eldoura: folds
Baksojor: folds
thiusk: raises $0.10 to $0.15
Astour194: folds
bohdanovitch: folds
pipecmolodec: folds
Uncalled bet ($0.10) returned to thiusk
thiusk collected $0.12 from pot
thiusk: doesn't show hand
*** SUMMARY ***
Total pot $0.12 | Rake $0
Seat 1: Astour194 (button) folded before Flop (didn't bet)
Seat 2: bohdanovitch (small blind) folded before Flop
Seat 3: pipecmolodec (big blind) folded before Flop
Seat 4: Eldoura folded before Flop (didn't bet)
Seat 5: Baksojor folded before Flop (didn't bet)
Seat 6: thiusk collected ($0.12)


*********** # 29 **************
PokerStars Zoom Hand #174065747527:  Hold'em No Limit ($0.02/$0.05) - 2017/08/08 11:07:41 MSK [2017/08/08 4:07:41 ET]
Table 'Donati' 6-max Seat #1 is the button
Seat 1: MutbKa01 ($5.41 in chips)
Seat 2: Baksojor ($6.19 in chips)
Seat 3: IRiverBluff ($5 in chips)
Seat 4: Shootnick88 ($6.05 in chips)
Seat 5: ale rocha ($1.27 in chips)
Seat 6: Eldoura ($5 in chips)
Baksojor: posts small blind $0.02
IRiverBluff: posts big blind $0.05
*** HOLE CARDS ***
Dealt to Baksojor [9h 7c]
Shootnick88: raises $0.10 to $0.15
ale rocha: folds
Eldoura: folds
MutbKa01: folds
Baksojor: folds
IRiverBluff: folds
Uncalled bet ($0.10) returned to Shootnick88
Shootnick88 collected $0.12 from pot
Shootnick88: doesn't show hand
*** SUMMARY ***
Total pot $0.12 | Rake $0
Seat 1: MutbKa01 (button) folded before Flop (didn't bet)
Seat 2: Baksojor (small blind) folded before Flop
Seat 3: IRiverBluff (big blind) folded before Flop
Seat 4: Shootnick88 collected ($0.12)
Seat 5: ale rocha folded before Flop (didn't bet)
Seat 6: Eldoura folded before Flop (didn't bet)


*********** # 30 **************
PokerStars Zoom Hand #174065746406:  Hold'em No Limit ($0.02/$0.05) - 2017/08/08 11:07:37 MSK [2017/08/08 4:07:37 ET]
Table 'Donati' 6-max Seat #1 is the button
Seat 1: ilkovv ($4.20 in chips)
Seat 2: taketwice ($4.23 in chips)
Seat 3: Grario ($5 in chips)
Seat 4: honeyjon ($5 in chips)
Seat 5: Astour194 ($6.82 in chips)
Seat 6: Baksojor ($6.19 in chips)
taketwice: posts small blind $0.02
Grario: posts big blind $0.05
*** HOLE CARDS ***
Dealt to Baksojor [3s Kc]
honeyjon: folds
Astour194: raises $0.08 to $0.13
Baksojor: folds
ilkovv: folds
taketwice: raises $0.31 to $0.44
Grario: folds
Astour194: calls $0.31
*** FLOP *** [Qh 6d 9s]
taketwice: bets $0.45
Astour194: folds
Uncalled bet ($0.45) returned to taketwice
taketwice collected $0.89 from pot
taketwice: doesn't show hand
*** SUMMARY ***
Total pot $0.93 | Rake $0.04
Board [Qh 6d 9s]
Seat 1: ilkovv (button) folded before Flop (didn't bet)
Seat 2: taketwice (small blind) collected ($0.89)
Seat 3: Grario (big blind) folded before Flop
Seat 4: honeyjon folded before Flop (didn't bet)
Seat 5: Astour194 folded on the Flop
Seat 6: Baksojor folded before Flop (didn't bet)


*********** # 31 **************
PokerStars Zoom Hand #174065736992:  Hold'em No Limit ($0.02/$0.05) - 2017/08/08 11:07:03 MSK [2017/08/08 4:07:03 ET]
Table 'Donati' 6-max Seat #1 is the button
Seat 1: V.S.151 ($7.72 in chips)
Seat 2: pokermagik46 ($5.11 in chips)
Seat 3: Baksojor ($6.05 in chips)
Seat 4: Brentyyy ($23.89 in chips)
Seat 5: Jape60 ($5.02 in chips)
Seat 6: nitzed12 ($5.21 in chips)
pokermagik46: posts small blind $0.02
Baksojor: posts big blind $0.05
*** HOLE CARDS ***
Dealt to Baksojor [6s 4s]
Brentyyy: folds
Jape60: folds
nitzed12: folds
V.S.151: raises $0.07 to $0.12
pokermagik46: folds
Baksojor: raises $0.38 to $0.50
V.S.151: folds
Uncalled bet ($0.38) returned to Baksojor
Baksojor collected $0.26 from pot
Baksojor: doesn't show hand
*** SUMMARY ***
Total pot $0.26 | Rake $0
Seat 1: V.S.151 (button) folded before Flop
Seat 2: pokermagik46 (small blind) folded before Flop
Seat 3: Baksojor (big blind) collected ($0.26)
Seat 4: Brentyyy folded before Flop (didn't bet)
Seat 5: Jape60 folded before Flop (didn't bet)
Seat 6: nitzed12 folded before Flop (didn't bet)


*********** # 32 **************
PokerStars Zoom Hand #174065728944:  Hold'em No Limit ($0.02/$0.05) - 2017/08/08 11:06:34 MSK [2017/08/08 4:06:34 ET]
Table 'Donati' 6-max Seat #1 is the button
Seat 1: Baksojor ($6.27 in chips)
Seat 2: 0xC0DEBEEF ($5 in chips)
Seat 3: bokunenjin ($5.14 in chips)
Seat 4: Dinara222 ($5.09 in chips)
Seat 5: Lubie Dve ($5 in chips)
Seat 6: orcaraptor ($5.91 in chips)
0xC0DEBEEF: posts small blind $0.02
bokunenjin: posts big blind $0.05
*** HOLE CARDS ***
Dealt to Baksojor [7s Ad]
Dinara222: folds
Lubie Dve: folds
orcaraptor: folds
Baksojor: raises $0.05 to $0.10
0xC0DEBEEF: folds
bokunenjin: calls $0.05
*** FLOP *** [Jd Qh Jh]
bokunenjin: checks
Baksojor: checks
*** TURN *** [Jd Qh Jh] [6s]
bokunenjin: checks
Baksojor: checks
*** RIVER *** [Jd Qh Jh 6s] [4h]
bokunenjin: bets $0.12
Baksojor: calls $0.12
*** SHOW DOWN ***
bokunenjin: shows [Tc Ts] (two pair, Jacks and Tens)
Baksojor: mucks hand
bokunenjin collected $0.44 from pot
*** SUMMARY ***
Total pot $0.46 | Rake $0.02
Board [Jd Qh Jh 6s 4h]
Seat 1: Baksojor (button) mucked [7s Ad]
Seat 2: 0xC0DEBEEF (small blind) folded before Flop
Seat 3: bokunenjin (big blind) showed [Tc Ts] and won ($0.44) with two pair, Jacks and Tens
Seat 4: Dinara222 folded before Flop (didn't bet)
Seat 5: Lubie Dve folded before Flop (didn't bet)
Seat 6: orcaraptor folded before Flop (didn't bet)


*********** # 33 **************
PokerStars Zoom Hand #174065727021:  Hold'em No Limit ($0.02/$0.05) - 2017/08/08 11:06:27 MSK [2017/08/08 4:06:27 ET]
Table 'Donati' 6-max Seat #1 is the button
Seat 1: rdavek ($10.24 in chips)
Seat 2: Astour194 ($5.50 in chips)
Seat 3: Shootnick88 ($5.60 in chips)
Seat 4: jimpoker1997 ($6.52 in chips)
Seat 5: edi_jos_amos ($5.05 in chips)
Seat 6: Baksojor ($6.27 in chips)
Astour194: posts small blind $0.02
Shootnick88: posts big blind $0.05
*** HOLE CARDS ***
Dealt to Baksojor [2c 4h]
jimpoker1997: folds
edi_jos_amos: raises $0.10 to $0.15
Baksojor: folds
rdavek: folds
Astour194: folds
Shootnick88: folds
Uncalled bet ($0.10) returned to edi_jos_amos
edi_jos_amos collected $0.12 from pot
edi_jos_amos: doesn't show hand
*** SUMMARY ***
Total pot $0.12 | Rake $0
Seat 1: rdavek (button) folded before Flop (didn't bet)
Seat 2: Astour194 (small blind) folded before Flop
Seat 3: Shootnick88 (big blind) folded before Flop
Seat 4: jimpoker1997 folded before Flop (didn't bet)
Seat 5: edi_jos_amos collected ($0.12)
Seat 6: Baksojor folded before Flop (didn't bet)


*********** # 34 **************
PokerStars Zoom Hand #174065720426:  Hold'em No Limit ($0.02/$0.05) - 2017/08/08 11:06:03 MSK [2017/08/08 4:06:03 ET]
Table 'Donati' 6-max Seat #1 is the button
Seat 1: bokunenjin ($5 in chips)
Seat 2: Baksojor ($6.29 in chips)
Seat 3: IRiverBluff ($5.06 in chips)
Seat 4: IvaGold ($6.99 in chips)
Seat 5: hunnybun888 ($5 in chips)
Seat 6: RealVipez ($3.10 in chips)
Baksojor: posts small blind $0.02
IRiverBluff: posts big blind $0.05
*** HOLE CARDS ***
Dealt to Baksojor [Ts Qd]
IvaGold: folds
hunnybun888: raises $0.08 to $0.13
RealVipez: folds
bokunenjin: folds
Baksojor: folds
IRiverBluff: calls $0.08
*** FLOP *** [Td Ah 5s]
IRiverBluff: checks
hunnybun888: bets $0.14
IRiverBluff: folds
Uncalled bet ($0.14) returned to hunnybun888
hunnybun888 collected $0.27 from pot
hunnybun888: doesn't show hand
*** SUMMARY ***
Total pot $0.28 | Rake $0.01
Board [Td Ah 5s]
Seat 1: bokunenjin (button) folded before Flop (didn't bet)
Seat 2: Baksojor (small blind) folded before Flop
Seat 3: IRiverBluff (big blind) folded on the Flop
Seat 4: IvaGold folded before Flop (didn't bet)
Seat 5: hunnybun888 collected ($0.27)
Seat 6: RealVipez folded before Flop (didn't bet)


*********** # 35 **************
PokerStars Zoom Hand #174065718497:  Hold'em No Limit ($0.02/$0.05) - 2017/08/08 11:05:56 MSK [2017/08/08 4:05:56 ET]
Table 'Donati' 6-max Seat #1 is the button
Seat 1: Baksojor ($6.29 in chips)
Seat 2: Sita1986 ($5.02 in chips)
Seat 3: Jape60 ($5 in chips)
Seat 4: bokunenjin ($5 in chips)
Seat 5: Loerus13 ($5.89 in chips)
Seat 6: kuzima_ge ($6.63 in chips)
Sita1986: posts small blind $0.02
Jape60: posts big blind $0.05
*** HOLE CARDS ***
Dealt to Baksojor [6d 8c]
bokunenjin: folds
Loerus13: folds
kuzima_ge: raises $0.07 to $0.12
Baksojor: folds
Sita1986: calls $0.10
Jape60: folds
*** FLOP *** [Ts 6c Qc]
Sita1986: checks
kuzima_ge: bets $0.18
Sita1986: folds
Uncalled bet ($0.18) returned to kuzima_ge
kuzima_ge collected $0.28 from pot
kuzima_ge: doesn't show hand
*** SUMMARY ***
Total pot $0.29 | Rake $0.01
Board [Ts 6c Qc]
Seat 1: Baksojor (button) folded before Flop (didn't bet)
Seat 2: Sita1986 (small blind) folded on the Flop
Seat 3: Jape60 (big blind) folded before Flop
Seat 4: bokunenjin folded before Flop (didn't bet)
Seat 5: Loerus13 folded before Flop (didn't bet)
Seat 6: kuzima_ge collected ($0.28)


*********** # 36 **************
PokerStars Zoom Hand #174065717144:  Hold'em No Limit ($0.02/$0.05) - 2017/08/08 11:05:51 MSK [2017/08/08 4:05:51 ET]
Table 'Donati' 6-max Seat #1 is the button
Seat 1: melodrama3 ($5.06 in chips)
Seat 2: Eldoura ($5 in chips)
Seat 3: LaMahiala ($7.20 in chips)
Seat 4: TeddyTaiwan ($5.34 in chips)
Seat 5: Baksojor ($6.29 in chips)
Seat 6: DrD.Phoenix ($6.03 in chips)
Eldoura: posts small blind $0.02
LaMahiala: posts big blind $0.05
*** HOLE CARDS ***
Dealt to Baksojor [7d 4h]
TeddyTaiwan: folds
Baksojor: folds
DrD.Phoenix: folds
melodrama3: folds
Eldoura: raises $0.10 to $0.15
LaMahiala: folds
Uncalled bet ($0.10) returned to Eldoura
Eldoura collected $0.10 from pot
Eldoura: doesn't show hand
*** SUMMARY ***
Total pot $0.10 | Rake $0
Seat 1: melodrama3 (button) folded before Flop (didn't bet)
Seat 2: Eldoura (small blind) collected ($0.10)
Seat 3: LaMahiala (big blind) folded before Flop
Seat 4: TeddyTaiwan folded before Flop (didn't bet)
Seat 5: Baksojor folded before Flop (didn't bet)
Seat 6: DrD.Phoenix folded before Flop (didn't bet)


*********** # 37 **************
PokerStars Zoom Hand #174065709720:  Hold'em No Limit ($0.02/$0.05) - 2017/08/08 11:05:24 MSK [2017/08/08 4:05:24 ET]
Table 'Donati' 6-max Seat #1 is the button
Seat 1: joekor00 ($5.26 in chips)
Seat 2: Nulanul ($9.85 in chips)
Seat 3: Baksojor ($5.97 in chips)
Seat 4: DrD.Phoenix ($6.10 in chips)
Seat 5: Brentyyy ($25.48 in chips)
Seat 6: bigcue81 ($7.14 in chips)
Nulanul: posts small blind $0.02
Baksojor: posts big blind $0.05
*** HOLE CARDS ***
Dealt to Baksojor [Qs Ac]
DrD.Phoenix: folds
Brentyyy: folds
bigcue81: raises $0.10 to $0.15
joekor00: calls $0.15
Nulanul: folds
Baksojor: raises $0.55 to $0.70
bigcue81: folds
joekor00: folds
Uncalled bet ($0.55) returned to Baksojor
Baksojor collected $0.47 from pot
Baksojor: doesn't show hand
*** SUMMARY ***
Total pot $0.47 | Rake $0
Seat 1: joekor00 (button) folded before Flop
Seat 2: Nulanul (small blind) folded before Flop
Seat 3: Baksojor (big blind) collected ($0.47)
Seat 4: DrD.Phoenix folded before Flop (didn't bet)
Seat 5: Brentyyy folded before Flop (didn't bet)
Seat 6: bigcue81 folded before Flop


*********** # 38 **************
PokerStars Zoom Hand #174065708657:  Hold'em No Limit ($0.02/$0.05) - 2017/08/08 11:05:20 MSK [2017/08/08 4:05:20 ET]
Table 'Donati' 6-max Seat #1 is the button
Seat 1: rdavek ($10.38 in chips)
Seat 2: Plutrach ($10.04 in chips)
Seat 3: buranela ($5.33 in chips)
Seat 4: Alexandro670 ($2.58 in chips)
Seat 5: Baksojor ($5.97 in chips)
Seat 6: Lessotto ($5 in chips)
Plutrach: posts small blind $0.02
buranela: posts big blind $0.05
*** HOLE CARDS ***
Dealt to Baksojor [3c 4d]
Alexandro670: folds
Baksojor: folds
Lessotto: folds
rdavek: folds
Plutrach: folds
Uncalled bet ($0.03) returned to buranela
buranela collected $0.04 from pot
buranela: doesn't show hand
*** SUMMARY ***
Total pot $0.04 | Rake $0
Seat 1: rdavek (button) folded before Flop (didn't bet)
Seat 2: Plutrach (small blind) folded before Flop
Seat 3: buranela (big blind) collected ($0.04)
Seat 4: Alexandro670 folded before Flop (didn't bet)
Seat 5: Baksojor folded before Flop (didn't bet)
Seat 6: Lessotto folded before Flop (didn't bet)


*********** # 39 **************
PokerStars Zoom Hand #174065706711:  Hold'em No Limit ($0.02/$0.05) - 2017/08/08 11:05:13 MSK [2017/08/08 4:05:13 ET]
Table 'Donati' 6-max Seat #1 is the button
Seat 1: fryspigs ($3.83 in chips)
Seat 2: antoxa oz ($5.05 in chips)
Seat 3: Loerus13 ($6.08 in chips)
Seat 4: Dinara222 ($4.91 in chips)
Seat 5: Lessotto ($5 in chips)
Seat 6: Baksojor ($5.97 in chips)
antoxa oz: posts small blind $0.02
Loerus13: posts big blind $0.05
*** HOLE CARDS ***
Dealt to Baksojor [6s Tc]
Dinara222: raises $0.12 to $0.17
Lessotto: folds
Baksojor: folds
fryspigs: folds
antoxa oz: folds
Loerus13: calls $0.12
*** FLOP *** [3h Kc Ad]
Loerus13: checks
Dinara222: checks
*** TURN *** [3h Kc Ad] [Jc]
Loerus13: checks
Dinara222: bets $0.35
Loerus13: folds
Uncalled bet ($0.35) returned to Dinara222
Dinara222 collected $0.35 from pot
Dinara222: doesn't show hand
*** SUMMARY ***
Total pot $0.36 | Rake $0.01
Board [3h Kc Ad Jc]
Seat 1: fryspigs (button) folded before Flop (didn't bet)
Seat 2: antoxa oz (small blind) folded before Flop
Seat 3: Loerus13 (big blind) folded on the Turn
Seat 4: Dinara222 collected ($0.35)
Seat 5: Lessotto folded before Flop (didn't bet)
Seat 6: Baksojor folded before Flop (didn't bet)


*********** # 40 **************
PokerStars Zoom Hand #174065699319:  Hold'em No Limit ($0.02/$0.05) - 2017/08/08 11:04:46 MSK [2017/08/08 4:04:46 ET]
Table 'Donati' 6-max Seat #1 is the button
Seat 1: MaxDVS ($9.42 in chips)
Seat 2: Baksojor ($5.80 in chips)
Seat 3: ser111375 ($5.17 in chips)
Seat 4: musvogel ($6.40 in chips)
Seat 5: pehtaras22 ($6.87 in chips)
Seat 6: rdavek ($10.29 in chips)
Baksojor: posts small blind $0.02
ser111375: posts big blind $0.05
*** HOLE CARDS ***
Dealt to Baksojor [8h Qh]
musvogel: folds
pehtaras22: folds
rdavek: folds
MaxDVS: raises $0.07 to $0.12
Baksojor: raises $0.38 to $0.50
ser111375: folds
MaxDVS: folds
Uncalled bet ($0.38) returned to Baksojor
Baksojor collected $0.29 from pot
Baksojor: doesn't show hand
*** SUMMARY ***
Total pot $0.29 | Rake $0
Seat 1: MaxDVS (button) folded before Flop
Seat 2: Baksojor (small blind) collected ($0.29)
Seat 3: ser111375 (big blind) folded before Flop
Seat 4: musvogel folded before Flop (didn't bet)
Seat 5: pehtaras22 folded before Flop (didn't bet)
Seat 6: rdavek folded before Flop (didn't bet)


*********** # 41 **************
PokerStars Zoom Hand #174065695157:  Hold'em No Limit ($0.02/$0.05) - 2017/08/08 11:04:31 MSK [2017/08/08 4:04:31 ET]
Table 'Donati' 6-max Seat #1 is the button
Seat 1: Baksojor ($5.80 in chips)
Seat 2: Schmarden ($9.52 in chips)
Seat 3: IRiverBluff ($5 in chips)
Seat 4: superkoro ($4.51 in chips)
Seat 5: Nkymmm ($7.09 in chips)
Seat 6: RiVeRBeLoW98 ($9.15 in chips)
Schmarden: posts small blind $0.02
IRiverBluff: posts big blind $0.05
*** HOLE CARDS ***
Dealt to Baksojor [Kc 2c]
superkoro: folds
Nkymmm: folds
RiVeRBeLoW98: raises $0.07 to $0.12
Baksojor: folds
Schmarden: folds
IRiverBluff: folds
Uncalled bet ($0.07) returned to RiVeRBeLoW98
RiVeRBeLoW98 collected $0.12 from pot
RiVeRBeLoW98: doesn't show hand
*** SUMMARY ***
Total pot $0.12 | Rake $0
Seat 1: Baksojor (button) folded before Flop (didn't bet)
Seat 2: Schmarden (small blind) folded before Flop
Seat 3: IRiverBluff (big blind) folded before Flop
Seat 4: superkoro folded before Flop (didn't bet)
Seat 5: Nkymmm folded before Flop (didn't bet)
Seat 6: RiVeRBeLoW98 collected ($0.12)


*********** # 42 **************
PokerStars Zoom Hand #174065693812:  Hold'em No Limit ($0.02/$0.05) - 2017/08/08 11:04:26 MSK [2017/08/08 4:04:26 ET]
Table 'Donati' 6-max Seat #1 is the button
Seat 1: PollyPeachum ($5 in chips)
Seat 2: Lasutchik ($4.88 in chips)
Seat 3: IRA217 ($4.12 in chips)
Seat 4: Baksojor ($5.80 in chips)
Seat 5: JIuMuHTa ($6.84 in chips)
Seat 6: Lessotto ($10 in chips)
Lasutchik: posts small blind $0.02
IRA217: posts big blind $0.05
*** HOLE CARDS ***
Dealt to Baksojor [4h Th]
Baksojor: folds
JIuMuHTa: folds
Lessotto: folds
PollyPeachum: folds
Lasutchik: raises $0.10 to $0.15
IRA217: folds
Uncalled bet ($0.10) returned to Lasutchik
Lasutchik collected $0.10 from pot
Lasutchik: doesn't show hand
*** SUMMARY ***
Total pot $0.10 | Rake $0
Seat 1: PollyPeachum (button) folded before Flop (didn't bet)
Seat 2: Lasutchik (small blind) collected ($0.10)
Seat 3: IRA217 (big blind) folded before Flop
Seat 4: Baksojor folded before Flop (didn't bet)
Seat 5: JIuMuHTa folded before Flop (didn't bet)
Seat 6: Lessotto folded before Flop (didn't bet)


*********** # 43 **************
PokerStars Zoom Hand #174065691897:  Hold'em No Limit ($0.02/$0.05) - 2017/08/08 11:04:19 MSK [2017/08/08 4:04:19 ET]
Table 'Donati' 6-max Seat #1 is the button
Seat 1: sportivnii ($10.03 in chips)
Seat 2: olig@rchic ($5.09 in chips)
Seat 3: Ben Legenden ($5.54 in chips)
Seat 4: freekidwei ($6.99 in chips)
Seat 5: Baksojor ($5.80 in chips)
Seat 6: xerrorPL ($5.60 in chips)
olig@rchic: posts small blind $0.02
Ben Legenden: posts big blind $0.05
*** HOLE CARDS ***
Dealt to Baksojor [6c Kc]
freekidwei: folds
Baksojor: folds
xerrorPL: folds
sportivnii: folds
olig@rchic: raises $0.05 to $0.10
Ben Legenden: calls $0.05
*** FLOP *** [6s 6h 4c]
olig@rchic: bets $0.05
Ben Legenden: calls $0.05
*** TURN *** [6s 6h 4c] [Ad]
olig@rchic: bets $0.20
Ben Legenden: folds
Uncalled bet ($0.20) returned to olig@rchic
olig@rchic collected $0.29 from pot
olig@rchic: doesn't show hand
*** SUMMARY ***
Total pot $0.30 | Rake $0.01
Board [6s 6h 4c Ad]
Seat 1: sportivnii (button) folded before Flop (didn't bet)
Seat 2: olig@rchic (small blind) collected ($0.29)
Seat 3: Ben Legenden (big blind) folded on the Turn
Seat 4: freekidwei folded before Flop (didn't bet)
Seat 5: Baksojor folded before Flop (didn't bet)
Seat 6: xerrorPL folded before Flop (didn't bet)


*********** # 44 **************
PokerStars Zoom Hand #174065683064:  Hold'em No Limit ($0.02/$0.05) - 2017/08/08 11:03:46 MSK [2017/08/08 4:03:46 ET]
Table 'Donati' 6-max Seat #1 is the button
Seat 1: 3iourou ($11.13 in chips)
Seat 2: musvogel ($6.60 in chips)
Seat 3: Baksojor ($6.30 in chips)
Seat 4: sportivnii ($10.08 in chips)
Seat 5: Plutrach ($10.21 in chips)
Seat 6: xerrorPL ($5.18 in chips)
musvogel: posts small blind $0.02
Baksojor: posts big blind $0.05
*** HOLE CARDS ***
Dealt to Baksojor [2h 2c]
sportivnii: folds
Plutrach: folds
xerrorPL: folds
3iourou: raises $0.07 to $0.12
musvogel: folds
Baksojor: raises $0.38 to $0.50
3iourou: raises $1 to $1.50
Baksojor: folds
Uncalled bet ($1) returned to 3iourou
3iourou collected $1.02 from pot
3iourou: doesn't show hand
*** SUMMARY ***
Total pot $1.02 | Rake $0
Seat 1: 3iourou (button) collected ($1.02)
Seat 2: musvogel (small blind) folded before Flop
Seat 3: Baksojor (big blind) folded before Flop
Seat 4: sportivnii folded before Flop (didn't bet)
Seat 5: Plutrach folded before Flop (didn't bet)
Seat 6: xerrorPL folded before Flop (didn't bet)


*********** # 45 **************
PokerStars Zoom Hand #174065681997:  Hold'em No Limit ($0.02/$0.05) - 2017/08/08 11:03:42 MSK [2017/08/08 4:03:42 ET]
Table 'Donati' 6-max Seat #1 is the button
Seat 1: RiVeRBeLoW98 ($13.52 in chips)
Seat 2: Baksojor ($6.32 in chips)
Seat 3: MaxDVS ($7.48 in chips)
Seat 4: 3iourou ($6.74 in chips)
Seat 5: olig@rchic ($5.14 in chips)
Seat 6: dark h0r$e ($5.59 in chips)
Baksojor: posts small blind $0.02
MaxDVS: posts big blind $0.05
*** HOLE CARDS ***
Dealt to Baksojor [Kd 3c]
3iourou: folds
olig@rchic: folds
dark h0r$e: folds
RiVeRBeLoW98: raises $0.07 to $0.12
Baksojor: folds
MaxDVS: folds
Uncalled bet ($0.07) returned to RiVeRBeLoW98
RiVeRBeLoW98 collected $0.12 from pot
RiVeRBeLoW98: doesn't show hand
*** SUMMARY ***
Total pot $0.12 | Rake $0
Seat 1: RiVeRBeLoW98 (button) collected ($0.12)
Seat 2: Baksojor (small blind) folded before Flop
Seat 3: MaxDVS (big blind) folded before Flop
Seat 4: 3iourou folded before Flop (didn't bet)
Seat 5: olig@rchic folded before Flop (didn't bet)
Seat 6: dark h0r$e folded before Flop (didn't bet)


*********** # 46 **************
PokerStars Zoom Hand #174065678448:  Hold'em No Limit ($0.02/$0.05) - 2017/08/08 11:03:29 MSK [2017/08/08 4:03:29 ET]
Table 'Donati' 6-max Seat #1 is the button
Seat 1: Cartman 8703 ($12.12 in chips)
Seat 2: JBatistaO ($5 in chips)
Seat 3: hunnybun888 ($5.13 in chips)
Seat 4: umair01982 ($9.99 in chips)
Seat 5: Baksojor ($6.25 in chips)
Seat 6: Astour194 ($5.58 in chips)
JBatistaO: posts small blind $0.02
hunnybun888: posts big blind $0.05
*** HOLE CARDS ***
Dealt to Baksojor [Qh Js]
umair01982: folds
Baksojor: raises $0.10 to $0.15
Astour194: folds
Cartman 8703: folds
JBatistaO: folds
hunnybun888: folds
Uncalled bet ($0.10) returned to Baksojor
Baksojor collected $0.12 from pot
Baksojor: doesn't show hand
*** SUMMARY ***
Total pot $0.12 | Rake $0
Seat 1: Cartman 8703 (button) folded before Flop (didn't bet)
Seat 2: JBatistaO (small blind) folded before Flop
Seat 3: hunnybun888 (big blind) folded before Flop
Seat 4: umair01982 folded before Flop (didn't bet)
Seat 5: Baksojor collected ($0.12)
Seat 6: Astour194 folded before Flop (didn't bet)


*********** # 47 **************
PokerStars Zoom Hand #174065665065:  Hold'em No Limit ($0.02/$0.05) - 2017/08/08 11:02:40 MSK [2017/08/08 4:02:40 ET]
Table 'Donati' 6-max Seat #1 is the button
Seat 1: Baksojor ($5.95 in chips)
Seat 2: IGROK101 ($5.07 in chips)
Seat 3: GetRhythm1 ($5.31 in chips)
Seat 4: thiusk ($15.48 in chips)
Seat 5: 0xC0DEBEEF ($5 in chips)
Seat 6: Sita1986 ($8.30 in chips)
IGROK101: posts small blind $0.02
GetRhythm1: posts big blind $0.05
*** HOLE CARDS ***
Dealt to Baksojor [Td Qc]
thiusk: folds
0xC0DEBEEF: raises $0.10 to $0.15
Sita1986: folds
Baksojor: calls $0.15
IGROK101: folds
GetRhythm1: calls $0.10
*** FLOP *** [9d Kh 7h]
GetRhythm1: checks
0xC0DEBEEF: checks
Baksojor: bets $0.30
GetRhythm1: folds
0xC0DEBEEF: folds
Uncalled bet ($0.30) returned to Baksojor
Baksojor collected $0.45 from pot
Baksojor: doesn't show hand
*** SUMMARY ***
Total pot $0.47 | Rake $0.02
Board [9d Kh 7h]
Seat 1: Baksojor (button) collected ($0.45)
Seat 2: IGROK101 (small blind) folded before Flop
Seat 3: GetRhythm1 (big blind) folded on the Flop
Seat 4: thiusk folded before Flop (didn't bet)
Seat 5: 0xC0DEBEEF folded on the Flop
Seat 6: Sita1986 folded before Flop (didn't bet)


*********** # 48 **************
PokerStars Zoom Hand #174065658095:  Hold'em No Limit ($0.02/$0.05) - 2017/08/08 11:02:14 MSK [2017/08/08 4:02:14 ET]
Table 'Donati' 6-max Seat #1 is the button
Seat 1: lan_spirit ($9.82 in chips)
Seat 2: nitzed12 ($5.11 in chips)
Seat 3: Baksojor ($6 in chips)
Seat 4: NISIY ($5.46 in chips)
Seat 5: MicroLocoNL ($5 in chips)
Seat 6: Halaa16 ($5.19 in chips)
nitzed12: posts small blind $0.02
Baksojor: posts big blind $0.05
*** HOLE CARDS ***
Dealt to Baksojor [Kc 3c]
NISIY: raises $0.10 to $0.15
MicroLocoNL: folds
Halaa16: folds
lan_spirit: folds
nitzed12: calls $0.13
Baksojor: folds
*** FLOP *** [6d 7d Kd]
nitzed12: checks
NISIY: checks
*** TURN *** [6d 7d Kd] [9d]
nitzed12: checks
NISIY: checks
*** RIVER *** [6d 7d Kd 9d] [7h]
nitzed12: bets $0.26
NISIY: folds
Uncalled bet ($0.26) returned to nitzed12
nitzed12 collected $0.34 from pot
nitzed12: doesn't show hand
*** SUMMARY ***
Total pot $0.35 | Rake $0.01
Board [6d 7d Kd 9d 7h]
Seat 1: lan_spirit (button) folded before Flop (didn't bet)
Seat 2: nitzed12 (small blind) collected ($0.34)
Seat 3: Baksojor (big blind) folded before Flop
Seat 4: NISIY folded on the River
Seat 5: MicroLocoNL folded before Flop (didn't bet)
Seat 6: Halaa16 folded before Flop (didn't bet)


*********** # 49 **************
PokerStars Zoom Hand #174065656776:  Hold'em No Limit ($0.02/$0.05) - 2017/08/08 11:02:09 MSK [2017/08/08 4:02:09 ET]
Table 'Donati' 6-max Seat #1 is the button
Seat 1: Schmarden ($7.24 in chips)
Seat 2: 01R#tS ($5.07 in chips)
Seat 3: AlexSun63 ($5.95 in chips)
Seat 4: Sita1986 ($7.27 in chips)
Seat 5: HighRaider ($5.99 in chips)
Seat 6: Baksojor ($6 in chips)
01R#tS: posts small blind $0.02
AlexSun63: posts big blind $0.05
*** HOLE CARDS ***
Dealt to Baksojor [8s 3d]
Sita1986: folds
HighRaider: raises $0.07 to $0.12
Baksojor: folds
Schmarden: folds
01R#tS: folds
AlexSun63: folds
Uncalled bet ($0.07) returned to HighRaider
HighRaider collected $0.12 from pot
HighRaider: doesn't show hand
*** SUMMARY ***
Total pot $0.12 | Rake $0
Seat 1: Schmarden (button) folded before Flop (didn't bet)
Seat 2: 01R#tS (small blind) folded before Flop
Seat 3: AlexSun63 (big blind) folded before Flop
Seat 4: Sita1986 folded before Flop (didn't bet)
Seat 5: HighRaider collected ($0.12)
Seat 6: Baksojor folded before Flop (didn't bet)


*********** # 50 **************
PokerStars Zoom Hand #174065644194:  Hold'em No Limit ($0.02/$0.05) - 2017/08/08 11:01:22 MSK [2017/08/08 4:01:22 ET]
Table 'Donati' 6-max Seat #1 is the button
Seat 1: Guest533 ($6.44 in chips)
Seat 2: Baksojor ($5.55 in chips)
Seat 3: BenHKN ($10.38 in chips)
Seat 4: ilsol ($11.67 in chips)
Seat 5: ser111375 ($5.57 in chips)
Seat 6: pehtaras22 ($12.16 in chips)
Baksojor: posts small blind $0.02
BenHKN: posts big blind $0.05
*** HOLE CARDS ***
Dealt to Baksojor [Ac Kc]
ilsol: folds
ser111375: folds
pehtaras22: folds
Guest533 has timed out
Guest533: folds
Baksojor: raises $0.10 to $0.15
BenHKN: raises $0.30 to $0.45
Baksojor: raises $1 to $1.45
BenHKN: folds
Uncalled bet ($1) returned to Baksojor
Baksojor collected $0.90 from pot
Baksojor: doesn't show hand
*** SUMMARY ***
Total pot $0.90 | Rake $0
Seat 1: Guest533 (button) folded before Flop (didn't bet)
Seat 2: Baksojor (small blind) collected ($0.90)
Seat 3: BenHKN (big blind) folded before Flop
Seat 4: ilsol folded before Flop (didn't bet)
Seat 5: ser111375 folded before Flop (didn't bet)
Seat 6: pehtaras22 folded before Flop (didn't bet)


*********** # 51 **************
PokerStars Zoom Hand #174065635022:  Hold'em No Limit ($0.02/$0.05) - 2017/08/08 11:00:47 MSK [2017/08/08 4:00:47 ET]
Table 'Donati' 6-max Seat #1 is the button
Seat 1: Loerus13 ($6.71 in chips)
Seat 2: nitzed12 ($5.02 in chips)
Seat 3: pehtaras22 ($11.87 in chips)
Seat 4: Baksojor ($5.85 in chips)
Seat 5: weraxx ($4.07 in chips)
Seat 6: svenev ($5.46 in chips)
nitzed12: posts small blind $0.02
pehtaras22: posts big blind $0.05
*** HOLE CARDS ***
Dealt to Baksojor [7c 9c]
Baksojor: raises $0.10 to $0.15
weraxx: folds
svenev: folds
Loerus13: folds
nitzed12: folds
pehtaras22: calls $0.10
*** FLOP *** [Jc Td 6h]
pehtaras22: checks
Baksojor: bets $0.15
pehtaras22: calls $0.15
*** TURN *** [Jc Td 6h] [Qh]
pehtaras22: checks
Baksojor: checks
*** RIVER *** [Jc Td 6h Qh] [4d]
pehtaras22: checks
Baksojor: checks
*** SHOW DOWN ***
pehtaras22: shows [Qc Kc] (a pair of Queens)
Baksojor: mucks hand
pehtaras22 collected $0.59 from pot
*** SUMMARY ***
Total pot $0.62 | Rake $0.03
Board [Jc Td 6h Qh 4d]
Seat 1: Loerus13 (button) folded before Flop (didn't bet)
Seat 2: nitzed12 (small blind) folded before Flop
Seat 3: pehtaras22 (big blind) showed [Qc Kc] and won ($0.59) with a pair of Queens
Seat 4: Baksojor mucked [7c 9c]
Seat 5: weraxx folded before Flop (didn't bet)
Seat 6: svenev folded before Flop (didn't bet)


*********** # 52 **************
PokerStars Zoom Hand #174065627515:  Hold'em No Limit ($0.02/$0.05) - 2017/08/08 11:00:17 MSK [2017/08/08 4:00:17 ET]
Table 'Donati' 6-max Seat #1 is the button
Seat 1: pehtaras22 ($11.89 in chips)
Seat 2: Bartduy ($7.61 in chips)
Seat 3: 777 Liang ($4.93 in chips)
Seat 4: hiebsch87 ($8.68 in chips)
Seat 5: Baksojor ($6.15 in chips)
Seat 6: merfol ($5.94 in chips)
Bartduy: posts small blind $0.02
777 Liang: posts big blind $0.05
*** HOLE CARDS ***
Dealt to Baksojor [8d 8c]
hiebsch87: folds
Baksojor: raises $0.10 to $0.15
merfol: folds
pehtaras22: folds
Bartduy: calls $0.13
777 Liang: folds
*** FLOP *** [Ac 4h 5c]
Bartduy: checks
Baksojor: bets $0.15
Bartduy: calls $0.15
*** TURN *** [Ac 4h 5c] [3d]
Bartduy: checks
Baksojor: checks
*** RIVER *** [Ac 4h 5c 3d] [Kh]
Bartduy: bets $0.31
Baksojor: folds
Uncalled bet ($0.31) returned to Bartduy
Bartduy collected $0.62 from pot
Bartduy: doesn't show hand
*** SUMMARY ***
Total pot $0.65 | Rake $0.03
Board [Ac 4h 5c 3d Kh]
Seat 1: pehtaras22 (button) folded before Flop (didn't bet)
Seat 2: Bartduy (small blind) collected ($0.62)
Seat 3: 777 Liang (big blind) folded before Flop
Seat 4: hiebsch87 folded before Flop (didn't bet)
Seat 5: Baksojor folded on the River
Seat 6: merfol folded before Flop (didn't bet)


*********** # 53 **************
PokerStars Zoom Hand #174065623118:  Hold'em No Limit ($0.02/$0.05) - 2017/08/08 10:59:59 MSK [2017/08/08 3:59:59 ET]
Table 'Donati' 6-max Seat #1 is the button
Seat 1: Baksojor ($6.15 in chips)
Seat 2: bokunenjin ($6.52 in chips)
Seat 3: ilsol ($11.72 in chips)
Seat 4: Situation.MR ($4.98 in chips)
Seat 5: judy2222 ($10.19 in chips)
Seat 6: misscheggars ($10.74 in chips)
bokunenjin: posts small blind $0.02
ilsol: posts big blind $0.05
*** HOLE CARDS ***
Dealt to Baksojor [9s 3h]
Situation.MR: folds
judy2222: folds
misscheggars: raises $0.07 to $0.12
Baksojor: folds
bokunenjin: folds
ilsol: folds
Uncalled bet ($0.07) returned to misscheggars
misscheggars collected $0.12 from pot
misscheggars: doesn't show hand
*** SUMMARY ***
Total pot $0.12 | Rake $0
Seat 1: Baksojor (button) folded before Flop (didn't bet)
Seat 2: bokunenjin (small blind) folded before Flop
Seat 3: ilsol (big blind) folded before Flop
Seat 4: Situation.MR folded before Flop (didn't bet)
Seat 5: judy2222 folded before Flop (didn't bet)
Seat 6: misscheggars collected ($0.12)


*********** # 54 **************
PokerStars Zoom Hand #174065619987:  Hold'em No Limit ($0.02/$0.05) - 2017/08/08 10:59:46 MSK [2017/08/08 3:59:46 ET]
Table 'Donati' 6-max Seat #1 is the button
Seat 1: hiebsch87 ($8.63 in chips)
Seat 2: Zav989 ($5.25 in chips)
Seat 3: Baksojor ($6.13 in chips)
Seat 4: Brentyyy ($11.12 in chips)
Seat 5: BigBangVzla ($7.68 in chips)
Seat 6: borntamer ($6.93 in chips)
Zav989: posts small blind $0.02
Baksojor: posts big blind $0.05
*** HOLE CARDS ***
Dealt to Baksojor [6d 7s]
Brentyyy: folds
BigBangVzla: folds
borntamer: folds
hiebsch87: folds
Zav989: folds
Uncalled bet ($0.03) returned to Baksojor
Baksojor collected $0.04 from pot
Baksojor: doesn't show hand
*** SUMMARY ***
Total pot $0.04 | Rake $0
Seat 1: hiebsch87 (button) folded before Flop (didn't bet)
Seat 2: Zav989 (small blind) folded before Flop
Seat 3: Baksojor (big blind) collected ($0.04)
Seat 4: Brentyyy folded before Flop (didn't bet)
Seat 5: BigBangVzla folded before Flop (didn't bet)
Seat 6: borntamer folded before Flop (didn't bet)


*********** # 55 **************
PokerStars Zoom Hand #174065614537:  Hold'em No Limit ($0.02/$0.05) - 2017/08/08 10:59:23 MSK [2017/08/08 3:59:23 ET]
Table 'Donati' 6-max Seat #1 is the button
Seat 1: bigfatlpjiji ($11.19 in chips)
Seat 2: Lubie Dve ($5.37 in chips)
Seat 3: maxiwin ($5 in chips)
Seat 4: hunnybun888 ($6.11 in chips)
Seat 5: C_Hammer03 ($8.26 in chips)
Seat 6: Baksojor ($6.25 in chips)
Lubie Dve: posts small blind $0.02
maxiwin: posts big blind $0.05
*** HOLE CARDS ***
Dealt to Baksojor [7s 6d]
hunnybun888: folds
C_Hammer03: folds
Baksojor: raises $0.07 to $0.12
bigfatlpjiji: calls $0.12
Lubie Dve: folds
maxiwin: calls $0.07
*** FLOP *** [2s 8c 6c]
maxiwin: bets $0.36
Baksojor: folds
bigfatlpjiji: folds
Uncalled bet ($0.36) returned to maxiwin
maxiwin collected $0.36 from pot
maxiwin: doesn't show hand
*** SUMMARY ***
Total pot $0.38 | Rake $0.02
Board [2s 8c 6c]
Seat 1: bigfatlpjiji (button) folded on the Flop
Seat 2: Lubie Dve (small blind) folded before Flop
Seat 3: maxiwin (big blind) collected ($0.36)
Seat 4: hunnybun888 folded before Flop (didn't bet)
Seat 5: C_Hammer03 folded before Flop (didn't bet)
Seat 6: Baksojor folded on the Flop


*********** # 56 **************
PokerStars Zoom Hand #174065613325:  Hold'em No Limit ($0.02/$0.05) - 2017/08/08 10:59:18 MSK [2017/08/08 3:59:18 ET]
Table 'Donati' 6-max Seat #1 is the button
Seat 1: BigBangVzla ($13.01 in chips)
Seat 2: rekoj504 ($5.07 in chips)
Seat 3: mnorde ($5.42 in chips)
Seat 4: Baksojor ($6.25 in chips)
Seat 5: AlexSun63 ($6.75 in chips)
Seat 6: pehtaras22 ($5.31 in chips)
rekoj504: posts small blind $0.02
mnorde: posts big blind $0.05
*** HOLE CARDS ***
Dealt to Baksojor [4s 6h]
Baksojor: folds
AlexSun63: folds
pehtaras22: folds
BigBangVzla: raises $0.10 to $0.15
rekoj504: folds
mnorde: folds
Uncalled bet ($0.10) returned to BigBangVzla
BigBangVzla collected $0.12 from pot
BigBangVzla: doesn't show hand
*** SUMMARY ***
Total pot $0.12 | Rake $0
Seat 1: BigBangVzla (button) collected ($0.12)
Seat 2: rekoj504 (small blind) folded before Flop
Seat 3: mnorde (big blind) folded before Flop
Seat 4: Baksojor folded before Flop (didn't bet)
Seat 5: AlexSun63 folded before Flop (didn't bet)
Seat 6: pehtaras22 folded before Flop (didn't bet)


*********** # 57 **************
PokerStars Zoom Hand #174065609681:  Hold'em No Limit ($0.02/$0.05) - 2017/08/08 10:59:03 MSK [2017/08/08 3:59:03 ET]
Table 'Donati' 6-max Seat #1 is the button
Seat 1: xerrorPL ($5 in chips)
Seat 2: Baksojor ($6.20 in chips)
Seat 3: MResetM ($5.14 in chips)
Seat 4: Jape60 ($5.32 in chips)
Seat 5: kelevra__375 ($5.28 in chips)
Seat 6: dark h0r$e ($5.90 in chips)
Baksojor: posts small blind $0.02
MResetM: posts big blind $0.05
*** HOLE CARDS ***
Dealt to Baksojor [5d 7d]
Jape60: folds
kelevra__375: folds
dark h0r$e: folds
xerrorPL: folds
Baksojor: raises $0.10 to $0.15
MResetM: folds
Uncalled bet ($0.10) returned to Baksojor
Baksojor collected $0.10 from pot
Baksojor: doesn't show hand
*** SUMMARY ***
Total pot $0.10 | Rake $0
Seat 1: xerrorPL (button) folded before Flop (didn't bet)
Seat 2: Baksojor (small blind) collected ($0.10)
Seat 3: MResetM (big blind) folded before Flop
Seat 4: Jape60 folded before Flop (didn't bet)
Seat 5: kelevra__375 folded before Flop (didn't bet)
Seat 6: dark h0r$e folded before Flop (didn't bet)


*********** # 58 **************
PokerStars Zoom Hand #174065608441:  Hold'em No Limit ($0.02/$0.05) - 2017/08/08 10:58:58 MSK [2017/08/08 3:58:58 ET]
Table 'Donati' 6-max Seat #1 is the button
Seat 1: ser111375 ($5.78 in chips)
Seat 2: bokunenjin ($5 in chips)
Seat 3: bajapple ($11.52 in chips)
Seat 4: Baksojor ($6.20 in chips)
Seat 5: Mechelburger ($5.78 in chips)
Seat 6: GetRhythm1 ($5.07 in chips)
bokunenjin: posts small blind $0.02
bajapple: posts big blind $0.05
*** HOLE CARDS ***
Dealt to Baksojor [4d 2c]
Baksojor: folds
Mechelburger: folds
GetRhythm1: folds
ser111375: folds
bokunenjin: raises $0.07 to $0.12
bajapple: calls $0.07
*** FLOP *** [9d 8h 2h]
bokunenjin: checks
bajapple: checks
*** TURN *** [9d 8h 2h] [8d]
bokunenjin: bets $0.16
bajapple: folds
Uncalled bet ($0.16) returned to bokunenjin
bokunenjin collected $0.23 from pot
bokunenjin: doesn't show hand
*** SUMMARY ***
Total pot $0.24 | Rake $0.01
Board [9d 8h 2h 8d]
Seat 1: ser111375 (button) folded before Flop (didn't bet)
Seat 2: bokunenjin (small blind) collected ($0.23)
Seat 3: bajapple (big blind) folded on the Turn
Seat 4: Baksojor folded before Flop (didn't bet)
Seat 5: Mechelburger folded before Flop (didn't bet)
Seat 6: GetRhythm1 folded before Flop (didn't bet)


*********** # 59 **************
PokerStars Zoom Hand #174065605619:  Hold'em No Limit ($0.02/$0.05) - 2017/08/08 10:58:46 MSK [2017/08/08 3:58:46 ET]
Table 'Donati' 6-max Seat #1 is the button
Seat 1: HighRaider ($5.78 in chips)
Seat 2: AndewRobin ($6.29 in chips)
Seat 3: Dasha_1989 ($5 in chips)
Seat 4: koribut ($5 in chips)
Seat 5: koshi712 ($11.90 in chips)
Seat 6: Baksojor ($6.20 in chips)
AndewRobin: posts small blind $0.02
Dasha_1989: posts big blind $0.05
*** HOLE CARDS ***
Dealt to Baksojor [5d Ac]
koribut: folds
koshi712: raises $0.10 to $0.15
Baksojor: folds
HighRaider: raises $0.18 to $0.33
AndewRobin: folds
Dasha_1989: folds
koshi712: folds
Uncalled bet ($0.18) returned to HighRaider
HighRaider collected $0.37 from pot
HighRaider: doesn't show hand
*** SUMMARY ***
Total pot $0.37 | Rake $0
Seat 1: HighRaider (button) collected ($0.37)
Seat 2: AndewRobin (small blind) folded before Flop
Seat 3: Dasha_1989 (big blind) folded before Flop
Seat 4: koribut folded before Flop (didn't bet)
Seat 5: koshi712 folded before Flop
Seat 6: Baksojor folded before Flop (didn't bet)


*********** # 60 **************
PokerStars Zoom Hand #174065602559:  Hold'em No Limit ($0.02/$0.05) - 2017/08/08 10:58:33 MSK [2017/08/08 3:58:33 ET]
Table 'Donati' 6-max Seat #1 is the button
Seat 1: Baksojor ($6.13 in chips)
Seat 2: GetRhythm1 ($5 in chips)
Seat 3: Mechelburger ($5.83 in chips)
Seat 4: ilsol ($8.06 in chips)
Seat 5: Brentyyy ($5.16 in chips)
Seat 6: petokrcmar ($3.11 in chips)
GetRhythm1: posts small blind $0.02
Mechelburger: posts big blind $0.05
*** HOLE CARDS ***
Dealt to Baksojor [9c Qs]
ilsol: folds
Brentyyy: folds
petokrcmar: folds
Baksojor: raises $0.05 to $0.10
GetRhythm1: folds
Mechelburger: folds
Uncalled bet ($0.05) returned to Baksojor
Baksojor collected $0.12 from pot
Baksojor: doesn't show hand
*** SUMMARY ***
Total pot $0.12 | Rake $0
Seat 1: Baksojor (button) collected ($0.12)
Seat 2: GetRhythm1 (small blind) folded before Flop
Seat 3: Mechelburger (big blind) folded before Flop
Seat 4: ilsol folded before Flop (didn't bet)
Seat 5: Brentyyy folded before Flop (didn't bet)
Seat 6: petokrcmar folded before Flop (didn't bet)


*********** # 61 **************
PokerStars Zoom Hand #174065599456:  Hold'em No Limit ($0.02/$0.05) - 2017/08/08 10:58:20 MSK [2017/08/08 3:58:20 ET]
Table 'Donati' 6-max Seat #1 is the button
Seat 1: GetRhythm1 ($5 in chips)
Seat 2: MicroLocoNL ($6.01 in chips)
Seat 3: svenev ($5.65 in chips)
Seat 4: laurbogdy ($4.11 in chips)
Seat 5: Baksojor ($6.06 in chips)
Seat 6: AttilaHun79 ($4.30 in chips)
MicroLocoNL: posts small blind $0.02
svenev: posts big blind $0.05
*** HOLE CARDS ***
Dealt to Baksojor [Ts Th]
laurbogdy: folds
Baksojor: raises $0.10 to $0.15
AttilaHun79: folds
GetRhythm1: folds
MicroLocoNL: folds
svenev: folds
Uncalled bet ($0.10) returned to Baksojor
Baksojor collected $0.12 from pot
Baksojor: doesn't show hand
*** SUMMARY ***
Total pot $0.12 | Rake $0
Seat 1: GetRhythm1 (button) folded before Flop (didn't bet)
Seat 2: MicroLocoNL (small blind) folded before Flop
Seat 3: svenev (big blind) folded before Flop
Seat 4: laurbogdy folded before Flop (didn't bet)
Seat 5: Baksojor collected ($0.12)
Seat 6: AttilaHun79 folded before Flop (didn't bet)


*********** # 62 **************
PokerStars Zoom Hand #174065593404:  Hold'em No Limit ($0.02/$0.05) - 2017/08/08 10:57:55 MSK [2017/08/08 3:57:55 ET]
Table 'Donati' 6-max Seat #1 is the button
Seat 1: AttilaHun79 ($4.25 in chips)
Seat 2: ciprianidis ($4.28 in chips)
Seat 3: Baksojor ($6.11 in chips)
Seat 4: Avtor(RUS) ($5.52 in chips)
Seat 5: bokunenjin ($6.63 in chips)
Seat 6: SynWiz ($11.91 in chips)
ciprianidis: posts small blind $0.02
Baksojor: posts big blind $0.05
*** HOLE CARDS ***
Dealt to Baksojor [3c Kd]
Avtor(RUS): folds
bokunenjin: folds
SynWiz: folds
AttilaHun79: folds
ciprianidis: raises $0.10 to $0.15
Baksojor: folds
Uncalled bet ($0.10) returned to ciprianidis
ciprianidis collected $0.10 from pot
ciprianidis: doesn't show hand
*** SUMMARY ***
Total pot $0.10 | Rake $0
Seat 1: AttilaHun79 (button) folded before Flop (didn't bet)
Seat 2: ciprianidis (small blind) collected ($0.10)
Seat 3: Baksojor (big blind) folded before Flop
Seat 4: Avtor(RUS) folded before Flop (didn't bet)
Seat 5: bokunenjin folded before Flop (didn't bet)
Seat 6: SynWiz folded before Flop (didn't bet)


*********** # 63 **************
PokerStars Zoom Hand #174065591667:  Hold'em No Limit ($0.02/$0.05) - 2017/08/08 10:57:48 MSK [2017/08/08 3:57:48 ET]
Table 'Donati' 6-max Seat #1 is the button
Seat 1: tsukikuu ($7.50 in chips)
Seat 2: romanshepp ($5 in chips)
Seat 3: digrol19 ($3.54 in chips)
Seat 4: asdeadsa ($8.44 in chips)
Seat 5: AEirilas ($5.24 in chips)
Seat 6: Baksojor ($6.11 in chips)
romanshepp: posts small blind $0.02
digrol19: posts big blind $0.05
*** HOLE CARDS ***
Dealt to Baksojor [6c 9h]
asdeadsa: raises $0.07 to $0.12
AEirilas: calls $0.12
Baksojor: folds
tsukikuu: folds
romanshepp: folds
digrol19: folds
*** FLOP *** [2s Ad Qs]
asdeadsa: bets $0.19
AEirilas: folds
Uncalled bet ($0.19) returned to asdeadsa
asdeadsa collected $0.30 from pot
asdeadsa: doesn't show hand
*** SUMMARY ***
Total pot $0.31 | Rake $0.01
Board [2s Ad Qs]
Seat 1: tsukikuu (button) folded before Flop (didn't bet)
Seat 2: romanshepp (small blind) folded before Flop
Seat 3: digrol19 (big blind) folded before Flop
Seat 4: asdeadsa collected ($0.30)
Seat 5: AEirilas folded on the Flop
Seat 6: Baksojor folded before Flop (didn't bet)


*********** # 64 **************
PokerStars Zoom Hand #174065590422:  Hold'em No Limit ($0.02/$0.05) - 2017/08/08 10:57:43 MSK [2017/08/08 3:57:43 ET]
Table 'Donati' 6-max Seat #1 is the button
Seat 1: borntamer ($5.06 in chips)
Seat 2: Baksojor ($6.13 in chips)
Seat 3: vremyannik ($4.69 in chips)
Seat 4: tsukikuu ($7.50 in chips)
Seat 5: LaMahiala ($8.80 in chips)
Seat 6: Shintaro327 ($12.63 in chips)
Baksojor: posts small blind $0.02
vremyannik: posts big blind $0.05
*** HOLE CARDS ***
Dealt to Baksojor [4c Qs]
tsukikuu: folds
LaMahiala: folds
Shintaro327: folds
borntamer: raises $0.07 to $0.12
Baksojor: folds
vremyannik: folds
Uncalled bet ($0.07) returned to borntamer
borntamer collected $0.12 from pot
borntamer: doesn't show hand
*** SUMMARY ***
Total pot $0.12 | Rake $0
Seat 1: borntamer (button) collected ($0.12)
Seat 2: Baksojor (small blind) folded before Flop
Seat 3: vremyannik (big blind) folded before Flop
Seat 4: tsukikuu folded before Flop (didn't bet)
Seat 5: LaMahiala folded before Flop (didn't bet)
Seat 6: Shintaro327 folded before Flop (didn't bet)


*********** # 65 **************
PokerStars Zoom Hand #174065588950:  Hold'em No Limit ($0.02/$0.05) - 2017/08/08 10:57:37 MSK [2017/08/08 3:57:37 ET]
Table 'Donati' 6-max Seat #1 is the button
Seat 1: Vivalie ($3.56 in chips)
Seat 2: kuzima_ge ($5.93 in chips)
Seat 3: thiusk ($5.02 in chips)
Seat 4: Baksojor ($6.13 in chips)
Seat 5: 01R#tS ($6.01 in chips)
Seat 6: scraj0519 ($9.19 in chips)
kuzima_ge: posts small blind $0.02
thiusk: posts big blind $0.05
*** HOLE CARDS ***
Dealt to Baksojor [2s Kc]
Baksojor: folds
01R#tS: folds
scraj0519: folds
Vivalie: folds
kuzima_ge: folds
Uncalled bet ($0.03) returned to thiusk
thiusk collected $0.04 from pot
thiusk: doesn't show hand
*** SUMMARY ***
Total pot $0.04 | Rake $0
Seat 1: Vivalie (button) folded before Flop (didn't bet)
Seat 2: kuzima_ge (small blind) folded before Flop
Seat 3: thiusk (big blind) collected ($0.04)
Seat 4: Baksojor folded before Flop (didn't bet)
Seat 5: 01R#tS folded before Flop (didn't bet)
Seat 6: scraj0519 folded before Flop (didn't bet)


*********** # 66 **************
PokerStars Zoom Hand #174065585548:  Hold'em No Limit ($0.02/$0.05) - 2017/08/08 10:57:23 MSK [2017/08/08 3:57:23 ET]
Table 'Donati' 6-max Seat #1 is the button
Seat 1: Baksojor ($6.13 in chips)
Seat 2: koribut ($5.07 in chips)
Seat 3: 3iourou ($8.65 in chips)
Seat 4: Supanyama ($5.07 in chips)
Seat 5: JBatistaO ($10.43 in chips)
Seat 6: vlad0512 ($11.07 in chips)
koribut: posts small blind $0.02
3iourou: posts big blind $0.05
*** HOLE CARDS ***
Dealt to Baksojor [4s 3d]
Supanyama: folds
JBatistaO: folds
vlad0512: raises $0.12 to $0.17
Baksojor: folds
koribut: calls $0.15
3iourou: calls $0.12
*** FLOP *** [8c As Td]
koribut: checks
3iourou: checks
vlad0512: bets $0.30
koribut: folds
3iourou: folds
Uncalled bet ($0.30) returned to vlad0512
vlad0512 collected $0.49 from pot
vlad0512: doesn't show hand
*** SUMMARY ***
Total pot $0.51 | Rake $0.02
Board [8c As Td]
Seat 1: Baksojor (button) folded before Flop (didn't bet)
Seat 2: koribut (small blind) folded on the Flop
Seat 3: 3iourou (big blind) folded on the Flop
Seat 4: Supanyama folded before Flop (didn't bet)
Seat 5: JBatistaO folded before Flop (didn't bet)
Seat 6: vlad0512 collected ($0.49)


*********** # 67 **************
PokerStars Zoom Hand #174065583834:  Hold'em No Limit ($0.02/$0.05) - 2017/08/08 10:57:16 MSK [2017/08/08 3:57:16 ET]
Table 'Donati' 6-max Seat #1 is the button
Seat 1: Culiacan448 ($6.65 in chips)
Seat 2: Jape60 ($5.46 in chips)
Seat 3: Loerus13 ($5.07 in chips)
Seat 4: Baksojor ($6.13 in chips)
Seat 5: bokunenjin ($5.12 in chips)
Seat 6: Peter T. 55 ($5.23 in chips)
Jape60: posts small blind $0.02
Loerus13: posts big blind $0.05
*** HOLE CARDS ***
Dealt to Baksojor [3h Qd]
Baksojor: folds
bokunenjin: folds
Peter T. 55: folds
Culiacan448: raises $0.07 to $0.12
Jape60: folds
Loerus13: folds
Uncalled bet ($0.07) returned to Culiacan448
Culiacan448 collected $0.12 from pot
Culiacan448: doesn't show hand
*** SUMMARY ***
Total pot $0.12 | Rake $0
Seat 1: Culiacan448 (button) collected ($0.12)
Seat 2: Jape60 (small blind) folded before Flop
Seat 3: Loerus13 (big blind) folded before Flop
Seat 4: Baksojor folded before Flop (didn't bet)
Seat 5: bokunenjin folded before Flop (didn't bet)
Seat 6: Peter T. 55 folded before Flop (didn't bet)


*********** # 68 **************
PokerStars Zoom Hand #174065576037:  Hold'em No Limit ($0.02/$0.05) - 2017/08/08 10:56:44 MSK [2017/08/08 3:56:44 ET]
Table 'Donati' 6-max Seat #1 is the button
Seat 1: Nkymmm ($6.15 in chips)
Seat 2: svenev ($5.77 in chips)
Seat 3: Baksojor ($5.37 in chips)
Seat 4: Stt1000 ($2.05 in chips)
Seat 5: Shootnick88 ($5.20 in chips)
Seat 6: coronaeu ($5 in chips)
svenev: posts small blind $0.02
Baksojor: posts big blind $0.05
*** HOLE CARDS ***
Dealt to Baksojor [Ad Qh]
Stt1000: raises $0.10 to $0.15
Shootnick88: folds
coronaeu: folds
Nkymmm: calls $0.15
svenev: folds
Baksojor: raises $0.50 to $0.65
Stt1000: calls $0.50
Nkymmm: folds
*** FLOP *** [Kh Jd 4d]
Baksojor: bets $1.40
Stt1000: folds
Uncalled bet ($1.40) returned to Baksojor
Baksojor collected $1.41 from pot
Baksojor: doesn't show hand
*** SUMMARY ***
Total pot $1.47 | Rake $0.06
Board [Kh Jd 4d]
Seat 1: Nkymmm (button) folded before Flop
Seat 2: svenev (small blind) folded before Flop
Seat 3: Baksojor (big blind) collected ($1.41)
Seat 4: Stt1000 folded on the Flop
Seat 5: Shootnick88 folded before Flop (didn't bet)
Seat 6: coronaeu folded before Flop (didn't bet)


*********** # 69 **************
PokerStars Zoom Hand #174065574799:  Hold'em No Limit ($0.02/$0.05) - 2017/08/08 10:56:39 MSK [2017/08/08 3:56:39 ET]
Table 'Donati' 6-max Seat #1 is the button
Seat 1: Dinara222 ($6.95 in chips)
Seat 2: AndewRobin ($6.53 in chips)
Seat 3: thiusk ($5 in chips)
Seat 4: antonis1988 ($5.42 in chips)
Seat 5: Baksojor ($5.37 in chips)
Seat 6: Jape60 ($8.56 in chips)
AndewRobin: posts small blind $0.02
thiusk: posts big blind $0.05
*** HOLE CARDS ***
Dealt to Baksojor [Qh 5s]
antonis1988: folds
Baksojor: folds
Jape60: folds
Dinara222: folds
AndewRobin: folds
Uncalled bet ($0.03) returned to thiusk
thiusk collected $0.04 from pot
thiusk: doesn't show hand
*** SUMMARY ***
Total pot $0.04 | Rake $0
Seat 1: Dinara222 (button) folded before Flop (didn't bet)
Seat 2: AndewRobin (small blind) folded before Flop
Seat 3: thiusk (big blind) collected ($0.04)
Seat 4: antonis1988 folded before Flop (didn't bet)
Seat 5: Baksojor folded before Flop (didn't bet)
Seat 6: Jape60 folded before Flop (didn't bet)


*********** # 70 **************
PokerStars Zoom Hand #174065571637:  Hold'em No Limit ($0.02/$0.05) - 2017/08/08 10:56:26 MSK [2017/08/08 3:56:26 ET]
Table 'Donati' 6-max Seat #1 is the button
Seat 1: IvaGold ($11.83 in chips)
Seat 2: Baksojor ($5.39 in chips)
Seat 3: AttilaHun79 ($4.71 in chips)
Seat 4: mnorde ($10.34 in chips)
Seat 5: asdeadsa ($16.34 in chips)
Seat 6: Krinkz ($5.62 in chips)
Baksojor: posts small blind $0.02
AttilaHun79: posts big blind $0.05
*** HOLE CARDS ***
Dealt to Baksojor [6d Ks]
mnorde: folds
asdeadsa: folds
Krinkz: folds
IvaGold: raises $0.07 to $0.12
Baksojor: folds
AttilaHun79: calls $0.07
*** FLOP *** [4c Ad 2s]
AttilaHun79: checks
IvaGold: bets $0.17
AttilaHun79: folds
Uncalled bet ($0.17) returned to IvaGold
IvaGold collected $0.25 from pot
IvaGold: doesn't show hand
*** SUMMARY ***
Total pot $0.26 | Rake $0.01
Board [4c Ad 2s]
Seat 1: IvaGold (button) collected ($0.25)
Seat 2: Baksojor (small blind) folded before Flop
Seat 3: AttilaHun79 (big blind) folded on the Flop
Seat 4: mnorde folded before Flop (didn't bet)
Seat 5: asdeadsa folded before Flop (didn't bet)
Seat 6: Krinkz folded before Flop (didn't bet)


*********** # 71 **************
PokerStars Zoom Hand #174065570698:  Hold'em No Limit ($0.02/$0.05) - 2017/08/08 10:56:22 MSK [2017/08/08 3:56:22 ET]
Table 'Donati' 6-max Seat #1 is the button
Seat 1: 0xC0DEBEEF ($5.51 in chips)
Seat 2: SynWiz ($10.07 in chips)
Seat 3: DreadF0ol ($5.14 in chips)
Seat 4: Baksojor ($5.39 in chips)
Seat 5: Krinkz ($5.10 in chips)
Seat 6: Vivalie ($3.78 in chips)
SynWiz: posts small blind $0.02
DreadF0ol: posts big blind $0.05
*** HOLE CARDS ***
Dealt to Baksojor [2d Tc]
Baksojor: folds
Krinkz: folds
Vivalie: raises $0.10 to $0.15
0xC0DEBEEF: folds
SynWiz: folds
DreadF0ol: folds
Uncalled bet ($0.10) returned to Vivalie
Vivalie collected $0.12 from pot
Vivalie: doesn't show hand
*** SUMMARY ***
Total pot $0.12 | Rake $0
Seat 1: 0xC0DEBEEF (button) folded before Flop (didn't bet)
Seat 2: SynWiz (small blind) folded before Flop
Seat 3: DreadF0ol (big blind) folded before Flop
Seat 4: Baksojor folded before Flop (didn't bet)
Seat 5: Krinkz folded before Flop (didn't bet)
Seat 6: Vivalie collected ($0.12)


*********** # 72 **************
PokerStars Zoom Hand #174065566061:  Hold'em No Limit ($0.02/$0.05) - 2017/08/08 10:56:03 MSK [2017/08/08 3:56:03 ET]
Table 'Donati' 6-max Seat #1 is the button
Seat 1: Dasha_1989 ($5.99 in chips)
Seat 2: MicroLocoNL ($6.18 in chips)
Seat 3: Supanyama ($5.28 in chips)
Seat 4: IGROK101 ($5.72 in chips)
Seat 5: StasKutuzov ($5.84 in chips)
Seat 6: Baksojor ($5.32 in chips)
MicroLocoNL: posts small blind $0.02
Supanyama: posts big blind $0.05
*** HOLE CARDS ***
Dealt to Baksojor [Ah 6s]
IGROK101: folds
StasKutuzov: folds
Baksojor: raises $0.07 to $0.12
Dasha_1989: folds
MicroLocoNL: folds
Supanyama: folds
Uncalled bet ($0.07) returned to Baksojor
Baksojor collected $0.12 from pot
Baksojor: doesn't show hand
*** SUMMARY ***
Total pot $0.12 | Rake $0
Seat 1: Dasha_1989 (button) folded before Flop (didn't bet)
Seat 2: MicroLocoNL (small blind) folded before Flop
Seat 3: Supanyama (big blind) folded before Flop
Seat 4: IGROK101 folded before Flop (didn't bet)
Seat 5: StasKutuzov folded before Flop (didn't bet)
Seat 6: Baksojor collected ($0.12)


*********** # 73 **************
PokerStars Zoom Hand #174065564841:  Hold'em No Limit ($0.02/$0.05) - 2017/08/08 10:55:58 MSK [2017/08/08 3:55:58 ET]
Table 'Donati' 6-max Seat #1 is the button
Seat 1: SynWiz ($11.63 in chips)
Seat 2: mnorde ($10.48 in chips)
Seat 3: jimpoker1997 ($6.27 in chips)
Seat 4: ineipet ($4.57 in chips)
Seat 5: Baksojor ($5.32 in chips)
Seat 6: Jape60 ($8.56 in chips)
mnorde: posts small blind $0.02
jimpoker1997: posts big blind $0.05
*** HOLE CARDS ***
Dealt to Baksojor [3d 7s]
ineipet: folds
Baksojor: folds
Jape60: folds
SynWiz: raises $0.07 to $0.12
mnorde: folds
jimpoker1997: folds
Uncalled bet ($0.07) returned to SynWiz
SynWiz collected $0.12 from pot
SynWiz: doesn't show hand
*** SUMMARY ***
Total pot $0.12 | Rake $0
Seat 1: SynWiz (button) collected ($0.12)
Seat 2: mnorde (small blind) folded before Flop
Seat 3: jimpoker1997 (big blind) folded before Flop
Seat 4: ineipet folded before Flop (didn't bet)
Seat 5: Baksojor folded before Flop (didn't bet)
Seat 6: Jape60 folded before Flop (didn't bet)


*********** # 74 **************
PokerStars Zoom Hand #174065558695:  Hold'em No Limit ($0.02/$0.05) - 2017/08/08 10:55:32 MSK [2017/08/08 3:55:32 ET]
Table 'Donati' 6-max Seat #1 is the button
Seat 1: Baksojor ($5 in chips)
Seat 2: edi_jos_amos ($5.15 in chips)
Seat 3: bokunenjin ($5.37 in chips)
Seat 4: Jack Dupped ($5.01 in chips)
Seat 5: Dasha_1989 ($5.99 in chips)
Seat 6: JBatistaO ($10.63 in chips)
edi_jos_amos: posts small blind $0.02
bokunenjin: posts big blind $0.05
*** HOLE CARDS ***
Dealt to Baksojor [Ks Ac]
Jack Dupped: calls $0.05
Dasha_1989: folds
JBatistaO: raises $0.15 to $0.20
Baksojor: raises $0.45 to $0.65
edi_jos_amos: folds
bokunenjin: folds
Jack Dupped: folds
JBatistaO: folds
Uncalled bet ($0.45) returned to Baksojor
Baksojor collected $0.52 from pot
Baksojor: doesn't show hand
*** SUMMARY ***
Total pot $0.52 | Rake $0
Seat 1: Baksojor (button) collected ($0.52)
Seat 2: edi_jos_amos (small blind) folded before Flop
Seat 3: bokunenjin (big blind) folded before Flop
Seat 4: Jack Dupped folded before Flop
Seat 5: Dasha_1989 folded before Flop (didn't bet)
Seat 6: JBatistaO folded before Flop


*********** # 75 **************
PokerStars Zoom Hand #174065557505:  Hold'em No Limit ($0.02/$0.05) - 2017/08/08 10:55:27 MSK [2017/08/08 3:55:27 ET]
Table 'Donati' 6-max Seat #1 is the button
Seat 1: JIuMuHTa ($14.36 in chips)
Seat 2: freekidwei ($7.04 in chips)
Seat 3: Brentyyy ($15.63 in chips)
Seat 4: Lessotto ($5.07 in chips)
Seat 5: Baksojor ($5 in chips)
Seat 6: Mark141278 ($4.67 in chips)
freekidwei: posts small blind $0.02
Brentyyy: posts big blind $0.05
*** HOLE CARDS ***
Dealt to Baksojor [9s 6s]
Lessotto: folds
Baksojor: folds
Mark141278: folds
JIuMuHTa: folds
freekidwei: folds
Uncalled bet ($0.03) returned to Brentyyy
Brentyyy collected $0.04 from pot
Brentyyy: doesn't show hand
*** SUMMARY ***
Total pot $0.04 | Rake $0
Seat 1: JIuMuHTa (button) folded before Flop (didn't bet)
Seat 2: freekidwei (small blind) folded before Flop
Seat 3: Brentyyy (big blind) collected ($0.04)
Seat 4: Lessotto folded before Flop (didn't bet)
Seat 5: Baksojor folded before Flop (didn't bet)
Seat 6: Mark141278 folded before Flop (didn't bet)


*********** # 76 **************
PokerStars Zoom Hand #174065552629:  Hold'em No Limit ($0.02/$0.05) - 2017/08/08 10:55:07 MSK [2017/08/08 3:55:07 ET]
Table 'Donati' 6-max Seat #1 is the button
Seat 1: Supanyama ($5 in chips)
Seat 2: Baksojor ($5.02 in chips)
Seat 3: Halaa16 ($5.51 in chips)
Seat 4: growingfish1 ($19.46 in chips)
Seat 5: LaMahiala ($8.80 in chips)
Seat 6: funtik00001 ($8.34 in chips)
Baksojor: posts small blind $0.02
Halaa16: posts big blind $0.05
*** HOLE CARDS ***
Dealt to Baksojor [Ts 6h]
growingfish1: folds
LaMahiala: folds
funtik00001: folds
Supanyama: folds
Baksojor: folds
Uncalled bet ($0.03) returned to Halaa16
Halaa16 collected $0.04 from pot
Halaa16: doesn't show hand
*** SUMMARY ***
Total pot $0.04 | Rake $0
Seat 1: Supanyama (button) folded before Flop (didn't bet)
Seat 2: Baksojor (small blind) folded before Flop
Seat 3: Halaa16 (big blind) collected ($0.04)
Seat 4: growingfish1 folded before Flop (didn't bet)
Seat 5: LaMahiala folded before Flop (didn't bet)
Seat 6: funtik00001 folded before Flop (didn't bet)


*********** # 77 **************
PokerStars Zoom Hand #174065548475:  Hold'em No Limit ($0.02/$0.05) - 2017/08/08 10:54:51 MSK [2017/08/08 3:54:51 ET]
Table 'Donati' 6-max Seat #1 is the button
Seat 1: Zav989 ($5 in chips)
Seat 2: 3iourou ($6.60 in chips)
Seat 3: Baksojor ($5 in chips)
Seat 4: ser111375 ($5.14 in chips)
Seat 5: tsukikuu ($6.54 in chips)
Seat 6: Cartman 8703 ($6.57 in chips)
3iourou: posts small blind $0.02
Baksojor: posts big blind $0.05
*** HOLE CARDS ***
Dealt to Baksojor [8s 9d]
ser111375: folds
tsukikuu: folds
Cartman 8703: folds
Zav989: folds
3iourou: folds
Uncalled bet ($0.03) returned to Baksojor
Baksojor collected $0.04 from pot
Baksojor: doesn't show hand
*** SUMMARY ***
Total pot $0.04 | Rake $0
Seat 1: Zav989 (button) folded before Flop (didn't bet)
Seat 2: 3iourou (small blind) folded before Flop
Seat 3: Baksojor (big blind) collected ($0.04)
Seat 4: ser111375 folded before Flop (didn't bet)
Seat 5: tsukikuu folded before Flop (didn't bet)
Seat 6: Cartman 8703 folded before Flop (didn't bet)


*********** # 78 **************
PokerStars Zoom Hand #174065530210:  Hold'em No Limit ($0.02/$0.05) - 2017/08/08 10:53:43 MSK [2017/08/08 3:53:43 ET]
Table 'Donati' 6-max Seat #1 is the button
Seat 1: davay300 ($5 in chips)
Seat 2: RiVeRBeLoW98 ($12.37 in chips)
Seat 3: anorectal ($8.89 in chips)
Seat 4: coronaeu ($5 in chips)
Seat 5: Jeff C Pipe ($5 in chips)
Seat 6: Baksojor ($5 in chips)
RiVeRBeLoW98: posts small blind $0.02
anorectal: posts big blind $0.05
*** HOLE CARDS ***
Dealt to Baksojor [7s Js]
coronaeu: folds
Jeff C Pipe: folds
Baksojor: raises $0.07 to $0.12
davay300: folds
RiVeRBeLoW98: folds
anorectal: calls $0.07
*** FLOP *** [Td 5s 7h]
anorectal: checks
Baksojor: bets $0.15
anorectal: calls $0.15
*** TURN *** [Td 5s 7h] [Kc]
anorectal: checks
Baksojor: checks
*** RIVER *** [Td 5s 7h Kc] [Ks]
anorectal: bets $0.46
Baksojor: calls $0.46
*** SHOW DOWN ***
anorectal: shows [9c 9h] (two pair, Kings and Nines)
Baksojor: mucks hand
anorectal collected $1.42 from pot
*** SUMMARY ***
Total pot $1.48 | Rake $0.06
Board [Td 5s 7h Kc Ks]
Seat 1: davay300 (button) folded before Flop (didn't bet)
Seat 2: RiVeRBeLoW98 (small blind) folded before Flop
Seat 3: anorectal (big blind) showed [9c 9h] and won ($1.42) with two pair, Kings and Nines
Seat 4: coronaeu folded before Flop (didn't bet)
Seat 5: Jeff C Pipe folded before Flop (didn't bet)
Seat 6: Baksojor mucked [7s Js]


*********** # 79 **************
PokerStars Zoom Hand #174065519049:  Hold'em No Limit ($0.02/$0.05) - 2017/08/08 10:53:01 MSK [2017/08/08 3:53:01 ET]
Table 'Donati' 6-max Seat #1 is the button
Seat 1: RiVeRBeLoW98 ($10.42 in chips)
Seat 2: IRA217 ($2.52 in chips)
Seat 3: kidvitis ($5.71 in chips)
Seat 4: Baksojor ($5 in chips)
Seat 5: musvogel ($5.39 in chips)
Seat 6: bigfatlpjiji ($10.39 in chips)
IRA217: posts small blind $0.02
kidvitis: posts big blind $0.05
*** HOLE CARDS ***
Dealt to Baksojor [5d 5s]
Baksojor: raises $0.10 to $0.15
musvogel: folds
bigfatlpjiji: raises $0.30 to $0.45
RiVeRBeLoW98: folds
IRA217: folds
kidvitis: folds
Baksojor: calls $0.30
*** FLOP *** [Kh 9d Js]
Baksojor: checks
bigfatlpjiji: bets $0.93
Baksojor: folds
Uncalled bet ($0.93) returned to bigfatlpjiji
bigfatlpjiji collected $0.93 from pot
bigfatlpjiji: doesn't show hand
*** SUMMARY ***
Total pot $0.97 | Rake $0.04
Board [Kh 9d Js]
Seat 1: RiVeRBeLoW98 (button) folded before Flop (didn't bet)
Seat 2: IRA217 (small blind) folded before Flop
Seat 3: kidvitis (big blind) folded before Flop
Seat 4: Baksojor folded on the Flop
Seat 5: musvogel folded before Flop (didn't bet)
Seat 6: bigfatlpjiji collected ($0.93)


*********** # 80 **************
PokerStars Zoom Hand #174065511477:  Hold'em No Limit ($0.02/$0.05) - 2017/08/08 10:52:33 MSK [2017/08/08 3:52:33 ET]
Table 'Donati' 6-max Seat #1 is the button
Seat 1: Baksojor ($5 in chips)
Seat 2: Stt1000 ($2.20 in chips)
Seat 3: Brentyyy ($5 in chips)
Seat 4: nielsa ($4.55 in chips)
Seat 5: svenev ($5 in chips)
Seat 6: 2704210 ($6.74 in chips)
Stt1000: posts small blind $0.02
Brentyyy: posts big blind $0.05
*** HOLE CARDS ***
Dealt to Baksojor [Ks 5s]
nielsa: calls $0.05
svenev: folds
2704210: calls $0.05
Baksojor: calls $0.05
Stt1000: folds
Brentyyy: checks
*** FLOP *** [7h 6d 9h]
Brentyyy: checks
nielsa: checks
2704210: checks
Baksojor: checks
*** TURN *** [7h 6d 9h] [Js]
Brentyyy: checks
nielsa: checks
2704210: bets $0.10
Baksojor: folds
Brentyyy: folds
nielsa: calls $0.10
*** RIVER *** [7h 6d 9h Js] [2s]
nielsa: checks
2704210: bets $0.10
nielsa: folds
Uncalled bet ($0.10) returned to 2704210
2704210 collected $0.40 from pot
2704210: doesn't show hand
*** SUMMARY ***
Total pot $0.42 | Rake $0.02
Board [7h 6d 9h Js 2s]
Seat 1: Baksojor (button) folded on the Turn
Seat 2: Stt1000 (small blind) folded before Flop
Seat 3: Brentyyy (big blind) folded on the Turn
Seat 4: nielsa folded on the River
Seat 5: svenev folded before Flop (didn't bet)
Seat 6: 2704210 collected ($0.40)


*********** # 81 **************
PokerStars Zoom Hand #174065506086:  Hold'em No Limit ($0.02/$0.05) - 2017/08/08 10:52:13 MSK [2017/08/08 3:52:13 ET]
Table 'Donati' 6-max Seat #1 is the button
Seat 1: kidvitis ($5 in chips)
Seat 2: growingfish1 ($19.06 in chips)
Seat 3: Baksojor ($5 in chips)
Seat 4: Jape60 ($5 in chips)
Seat 5: Brentyyy ($17.52 in chips)
Seat 6: coronaeu ($5.10 in chips)
growingfish1: posts small blind $0.02
Baksojor: posts big blind $0.05
*** HOLE CARDS ***
Dealt to Baksojor [4h 8s]
Jape60: folds
Brentyyy: folds
coronaeu: folds
kidvitis: raises $0.07 to $0.12
growingfish1: raises $0.33 to $0.45
Baksojor: folds
kidvitis: calls $0.33
*** FLOP *** [Ac Qc Th]
growingfish1: bets $0.56
kidvitis: folds
Uncalled bet ($0.56) returned to growingfish1
growingfish1 collected $0.91 from pot
growingfish1: doesn't show hand
*** SUMMARY ***
Total pot $0.95 | Rake $0.04
Board [Ac Qc Th]
Seat 1: kidvitis (button) folded on the Flop
Seat 2: growingfish1 (small blind) collected ($0.91)
Seat 3: Baksojor (big blind) folded before Flop
Seat 4: Jape60 folded before Flop (didn't bet)
Seat 5: Brentyyy folded before Flop (didn't bet)
Seat 6: coronaeu folded before Flop (didn't bet)


*********** # 82 **************
PokerStars Zoom Hand #174065479217:  Hold'em No Limit ($0.02/$0.05) - 2017/08/08 10:50:33 MSK [2017/08/08 3:50:33 ET]
Table 'Donati' 6-max Seat #1 is the button
Seat 1: TeddyTaiwan ($5 in chips)
Seat 2: Baksojor ($6.32 in chips)
Seat 3: jimpoker1997 ($6.33 in chips)
Seat 4: AEirilas ($4.85 in chips)
Seat 5: nitzed12 ($5 in chips)
Seat 6: growingfish1 ($13.22 in chips)
Baksojor: posts small blind $0.02
jimpoker1997: posts big blind $0.05
*** HOLE CARDS ***
Dealt to Baksojor [5s 3s]
AEirilas has timed out
AEirilas: folds
nitzed12: folds
growingfish1: raises $0.10 to $0.15
TeddyTaiwan: folds
Baksojor: raises $0.45 to $0.60
jimpoker1997: folds
growingfish1: calls $0.45
*** FLOP *** [Tc 2c Th]
Baksojor: bets $0.65
growingfish1: calls $0.65
*** TURN *** [Tc 2c Th] [Jc]
Baksojor: checks
growingfish1: bets $2
Baksojor: raises $3.07 to $5.07 and is all-in
growingfish1: calls $3.07
*** RIVER *** [Tc 2c Th Jc] [Kc]
*** SHOW DOWN ***
Baksojor: shows [5s 3s] (a pair of Tens)
growingfish1: shows [Kd Qc] (a flush, King high)
growingfish1 collected $12.16 from pot
*** SUMMARY ***
Total pot $12.69 | Rake $0.53
Board [Tc 2c Th Jc Kc]
Seat 1: TeddyTaiwan (button) folded before Flop (didn't bet)
Seat 2: Baksojor (small blind) showed [5s 3s] and lost with a pair of Tens
Seat 3: jimpoker1997 (big blind) folded before Flop
Seat 4: AEirilas folded before Flop (didn't bet)
Seat 5: nitzed12 folded before Flop (didn't bet)
Seat 6: growingfish1 showed [Kd Qc] and won ($12.16) with a flush, King high


*********** # 83 **************
PokerStars Zoom Hand #174065477873:  Hold'em No Limit ($0.02/$0.05) - 2017/08/08 10:50:28 MSK [2017/08/08 3:50:28 ET]
Table 'Donati' 6-max Seat #1 is the button
Seat 1: lz3500 ($4.73 in chips)
Seat 2: IGOR1957 ($8.89 in chips)
Seat 3: MaxDVS ($6.21 in chips)
Seat 4: Baksojor ($6.32 in chips)
Seat 5: RiVeRBeLoW98 ($14 in chips)
Seat 6: Jape60 ($5 in chips)
IGOR1957: posts small blind $0.02
MaxDVS: posts big blind $0.05
*** HOLE CARDS ***
Dealt to Baksojor [Qd 6s]
Baksojor: folds
RiVeRBeLoW98: folds
Jape60: folds
lz3500: folds
IGOR1957: folds
Uncalled bet ($0.03) returned to MaxDVS
MaxDVS collected $0.04 from pot
MaxDVS: doesn't show hand
*** SUMMARY ***
Total pot $0.04 | Rake $0
Seat 1: lz3500 (button) folded before Flop (didn't bet)
Seat 2: IGOR1957 (small blind) folded before Flop
Seat 3: MaxDVS (big blind) collected ($0.04)
Seat 4: Baksojor folded before Flop (didn't bet)
Seat 5: RiVeRBeLoW98 folded before Flop (didn't bet)
Seat 6: Jape60 folded before Flop (didn't bet)


*********** # 84 **************
PokerStars Zoom Hand #174065476512:  Hold'em No Limit ($0.02/$0.05) - 2017/08/08 10:50:23 MSK [2017/08/08 3:50:23 ET]
Table 'Donati' 6-max Seat #1 is the button
Seat 1: Brentyyy ($16.96 in chips)
Seat 2: Vivalie ($4.05 in chips)
Seat 3: aqvarel80 ($6.95 in chips)
Seat 4: Cartman 8703 ($5.99 in chips)
Seat 5: judy2222 ($5 in chips)
Seat 6: Baksojor ($6.32 in chips)
Vivalie: posts small blind $0.02
aqvarel80: posts big blind $0.05
*** HOLE CARDS ***
Dealt to Baksojor [8c 4c]
Cartman 8703: raises $0.10 to $0.15
judy2222: folds
Baksojor: folds
Brentyyy: folds
Vivalie: calls $0.13
aqvarel80: calls $0.10
*** FLOP *** [3s 8d Kd]
Vivalie: checks
aqvarel80: checks
Cartman 8703: bets $0.25
Vivalie: folds
aqvarel80: folds
Uncalled bet ($0.25) returned to Cartman 8703
Cartman 8703 collected $0.43 from pot
Cartman 8703: doesn't show hand
*** SUMMARY ***
Total pot $0.45 | Rake $0.02
Board [3s 8d Kd]
Seat 1: Brentyyy (button) folded before Flop (didn't bet)
Seat 2: Vivalie (small blind) folded on the Flop
Seat 3: aqvarel80 (big blind) folded on the Flop
Seat 4: Cartman 8703 collected ($0.43)
Seat 5: judy2222 folded before Flop (didn't bet)
Seat 6: Baksojor folded before Flop (didn't bet)


*********** # 85 **************
PokerStars Zoom Hand #174065473593:  Hold'em No Limit ($0.02/$0.05) - 2017/08/08 10:50:12 MSK [2017/08/08 3:50:12 ET]
Table 'Donati' 6-max Seat #1 is the button
Seat 1: Baksojor ($6.32 in chips)
Seat 2: annonymus27 ($4.95 in chips)
Seat 3: SynWiz ($5 in chips)
Seat 4: bajapple ($9.10 in chips)
Seat 5: Halaa16 ($6.32 in chips)
Seat 6: t$unami cr ($18.28 in chips)
annonymus27: posts small blind $0.02
SynWiz: posts big blind $0.05
*** HOLE CARDS ***
Dealt to Baksojor [Tc 3h]
bajapple: raises $0.10 to $0.15
Halaa16: raises $0.30 to $0.45
t$unami cr: folds
Baksojor: folds
annonymus27: folds
SynWiz: calls $0.40
bajapple: calls $0.30
*** FLOP *** [6d 5d Kh]
SynWiz: checks
bajapple: checks
Halaa16: bets $0.41
SynWiz: raises $0.41 to $0.82
bajapple: folds
Halaa16: calls $0.41
*** TURN *** [6d 5d Kh] [9s]
SynWiz: bets $1.70
Halaa16: raises $3.35 to $5.05 and is all-in
SynWiz: calls $2.03 and is all-in
Uncalled bet ($1.32) returned to Halaa16
*** FIRST RIVER *** [6d 5d Kh 9s] [4h]
*** SECOND RIVER *** [6d 5d Kh 9s] [Td]
*** FIRST SHOW DOWN ***
SynWiz: shows [5h 5c] (three of a kind, Fives)
Halaa16: shows [Ad Ah] (a pair of Aces)
SynWiz collected $5.02 from pot
*** SECOND SHOW DOWN ***
SynWiz: shows [5h 5c] (three of a kind, Fives)
Halaa16: shows [Ad Ah] (a pair of Aces)
SynWiz collected $5.02 from pot
*** SUMMARY ***
Total pot $10.47 | Rake $0.43
Hand was run twice
FIRST Board [6d 5d Kh 9s 4h]
SECOND Board [6d 5d Kh 9s Td]
Seat 1: Baksojor (button) folded before Flop (didn't bet)
Seat 2: annonymus27 (small blind) folded before Flop
Seat 3: SynWiz (big blind) showed [5h 5c] and won ($5.02) with three of a kind, Fives, and won ($5.02) with three of a kind, Fives
Seat 4: bajapple folded on the Flop
Seat 5: Halaa16 showed [Ad Ah] and lost with a pair of Aces, and lost with a pair of Aces
Seat 6: t$unami cr folded before Flop (didn't bet)


*********** # 86 **************
PokerStars Zoom Hand #174065462735:  Hold'em No Limit ($0.02/$0.05) - 2017/08/08 10:49:31 MSK [2017/08/08 3:49:31 ET]
Table 'Donati' 6-max Seat #1 is the button
Seat 1: Brentyyy ($11.11 in chips)
Seat 2: IvaGold ($11.98 in chips)
Seat 3: Baksojor ($6.18 in chips)
Seat 4: reibejk ($7.25 in chips)
Seat 5: Shintaro327 ($5.39 in chips)
Seat 6: 3iourou ($7.37 in chips)
IvaGold: posts small blind $0.02
Baksojor: posts big blind $0.05
*** HOLE CARDS ***
Dealt to Baksojor [2c Ac]
reibejk: folds
Shintaro327: folds
3iourou: raises $0.07 to $0.12
Brentyyy: folds
IvaGold: folds
Baksojor: raises $0.38 to $0.50
3iourou: folds
Uncalled bet ($0.38) returned to Baksojor
Baksojor collected $0.26 from pot
Baksojor: doesn't show hand
*** SUMMARY ***
Total pot $0.26 | Rake $0
Seat 1: Brentyyy (button) folded before Flop (didn't bet)
Seat 2: IvaGold (small blind) folded before Flop
Seat 3: Baksojor (big blind) collected ($0.26)
Seat 4: reibejk folded before Flop (didn't bet)
Seat 5: Shintaro327 folded before Flop (didn't bet)
Seat 6: 3iourou folded before Flop


*********** # 87 **************
PokerStars Zoom Hand #174065460335:  Hold'em No Limit ($0.02/$0.05) - 2017/08/08 10:49:22 MSK [2017/08/08 3:49:22 ET]
Table 'Donati' 6-max Seat #1 is the button
Seat 1: kuzima_ge ($5.07 in chips)
Seat 2: Baksojor ($6.20 in chips)
Seat 3: K1N3G3L69 ($6.57 in chips)
Seat 4: nielsa ($4.54 in chips)
Seat 5: SaMCoN83 ($5 in chips)
Seat 6: hiebsch87 ($5.07 in chips)
Baksojor: posts small blind $0.02
K1N3G3L69: posts big blind $0.05
*** HOLE CARDS ***
Dealt to Baksojor [5h 4c]
nielsa: folds
SaMCoN83: folds
hiebsch87: raises $0.07 to $0.12
kuzima_ge: folds
Baksojor: folds
K1N3G3L69: calls $0.07
*** FLOP *** [6h 6c 3s]
K1N3G3L69: bets $0.20
hiebsch87: calls $0.20
*** TURN *** [6h 6c 3s] [2h]
K1N3G3L69: bets $0.25
hiebsch87: calls $0.25
*** RIVER *** [6h 6c 3s 2h] [8s]
K1N3G3L69: checks
hiebsch87: checks
*** SHOW DOWN ***
K1N3G3L69: shows [7d Ad] (a pair of Sixes)
hiebsch87: shows [Ah Kd] (a pair of Sixes - Ace+King kicker)
hiebsch87 collected $1.11 from pot
*** SUMMARY ***
Total pot $1.16 | Rake $0.05
Board [6h 6c 3s 2h 8s]
Seat 1: kuzima_ge (button) folded before Flop (didn't bet)
Seat 2: Baksojor (small blind) folded before Flop
Seat 3: K1N3G3L69 (big blind) showed [7d Ad] and lost with a pair of Sixes
Seat 4: nielsa folded before Flop (didn't bet)
Seat 5: SaMCoN83 folded before Flop (didn't bet)
Seat 6: hiebsch87 showed [Ah Kd] and won ($1.11) with a pair of Sixes


*********** # 88 **************
PokerStars Zoom Hand #174065459255:  Hold'em No Limit ($0.02/$0.05) - 2017/08/08 10:49:18 MSK [2017/08/08 3:49:18 ET]
Table 'Donati' 6-max Seat #1 is the button
Seat 1: hedfiddla ($14.72 in chips)
Seat 2: jimpoker1997 ($6.60 in chips)
Seat 3: NISIY ($5 in chips)
Seat 4: Dasha_1989 ($5.09 in chips)
Seat 5: Baksojor ($6.20 in chips)
Seat 6: Volodya 2762 ($5.89 in chips)
jimpoker1997: posts small blind $0.02
NISIY: posts big blind $0.05
*** HOLE CARDS ***
Dealt to Baksojor [Th 4h]
Dasha_1989: folds
Baksojor: folds
Volodya 2762: folds
hedfiddla: folds
jimpoker1997: folds
Uncalled bet ($0.03) returned to NISIY
NISIY collected $0.04 from pot
NISIY: doesn't show hand
*** SUMMARY ***
Total pot $0.04 | Rake $0
Seat 1: hedfiddla (button) folded before Flop (didn't bet)
Seat 2: jimpoker1997 (small blind) folded before Flop
Seat 3: NISIY (big blind) collected ($0.04)
Seat 4: Dasha_1989 folded before Flop (didn't bet)
Seat 5: Baksojor folded before Flop (didn't bet)
Seat 6: Volodya 2762 folded before Flop (didn't bet)


*********** # 89 **************
PokerStars Zoom Hand #174065450777:  Hold'em No Limit ($0.02/$0.05) - 2017/08/08 10:48:46 MSK [2017/08/08 3:48:46 ET]
Table 'Donati' 6-max Seat #1 is the button
Seat 1: davay300 ($9.63 in chips)
Seat 2: Cartman 8703 ($5.61 in chips)
Seat 3: CBUHOKOHb-1 ($7.80 in chips)
Seat 4: Baksojor ($5.06 in chips)
Seat 5: wollefgang52 ($4.55 in chips)
Seat 6: NISIY ($5 in chips)
Cartman 8703: posts small blind $0.02
CBUHOKOHb-1: posts big blind $0.05
*** HOLE CARDS ***
Dealt to Baksojor [7c 7h]
Baksojor: raises $0.10 to $0.15
wollefgang52: raises $0.37 to $0.52
NISIY: folds
davay300: folds
Cartman 8703: folds
CBUHOKOHb-1: folds
Baksojor: calls $0.37
*** FLOP *** [8h 9s 6d]
Baksojor: checks
wollefgang52: bets $0.05
Baksojor: raises $0.60 to $0.65
wollefgang52: calls $0.60
*** TURN *** [8h 9s 6d] [4c]
Baksojor: bets $3.89 and is all-in
wollefgang52: folds
Uncalled bet ($3.89) returned to Baksojor
Baksojor collected $2.31 from pot
Baksojor: doesn't show hand
*** SUMMARY ***
Total pot $2.41 | Rake $0.10
Board [8h 9s 6d 4c]
Seat 1: davay300 (button) folded before Flop (didn't bet)
Seat 2: Cartman 8703 (small blind) folded before Flop
Seat 3: CBUHOKOHb-1 (big blind) folded before Flop
Seat 4: Baksojor collected ($2.31)
Seat 5: wollefgang52 folded on the Turn
Seat 6: NISIY folded before Flop (didn't bet)


*********** # 90 **************
PokerStars Zoom Hand #174065426511:  Hold'em No Limit ($0.02/$0.05) - 2017/08/08 10:47:15 MSK [2017/08/08 3:47:15 ET]
Table 'Donati' 6-max Seat #1 is the button
Seat 1: Baksojor ($6.41 in chips)
Seat 2: DrD.Phoenix ($5.81 in chips)
Seat 3: MResetM ($5.96 in chips)
Seat 4: luke cage0 ($4.57 in chips)
Seat 5: BenHKN ($7.07 in chips)
Seat 6: Jape60 ($5.02 in chips)
DrD.Phoenix: posts small blind $0.02
MResetM: posts big blind $0.05
*** HOLE CARDS ***
Dealt to Baksojor [Ad 8h]
luke cage0: folds
BenHKN: folds
Jape60: folds
Baksojor: raises $0.05 to $0.10
DrD.Phoenix: calls $0.08
MResetM: folds
*** FLOP *** [4c Td 6d]
DrD.Phoenix: checks
Baksojor: bets $0.15
DrD.Phoenix: raises $0.30 to $0.45
Baksojor: calls $0.30
*** TURN *** [4c Td 6d] [2h]
DrD.Phoenix: bets $0.80
Baksojor: calls $0.80
*** RIVER *** [4c Td 6d 2h] [9s]
DrD.Phoenix: bets $2
Baksojor: folds
Uncalled bet ($2) returned to DrD.Phoenix
DrD.Phoenix collected $2.64 from pot
DrD.Phoenix: doesn't show hand
*** SUMMARY ***
Total pot $2.75 | Rake $0.11
Board [4c Td 6d 2h 9s]
Seat 1: Baksojor (button) folded on the River
Seat 2: DrD.Phoenix (small blind) collected ($2.64)
Seat 3: MResetM (big blind) folded before Flop
Seat 4: luke cage0 folded before Flop (didn't bet)
Seat 5: BenHKN folded before Flop (didn't bet)
Seat 6: Jape60 folded before Flop (didn't bet)


*********** # 91 **************
PokerStars Zoom Hand #174065416561:  Hold'em No Limit ($0.02/$0.05) - 2017/08/08 10:46:38 MSK [2017/08/08 3:46:38 ET]
Table 'Donati' 6-max Seat #1 is the button
Seat 1: 01R#tS ($5.54 in chips)
Seat 2: Shintaro327 ($7.96 in chips)
Seat 3: IvaGold ($12.53 in chips)
Seat 4: zaporozhko ($4.95 in chips)
Seat 5: a91891981 ($6.57 in chips)
Seat 6: Baksojor ($6.38 in chips)
Shintaro327: posts small blind $0.02
IvaGold: posts big blind $0.05
*** HOLE CARDS ***
Dealt to Baksojor [Ad 6d]
zaporozhko: folds
a91891981: raises $0.07 to $0.12
Baksojor: calls $0.12
01R#tS: folds
Shintaro327: folds
IvaGold: folds
*** FLOP *** [2c 4c 5c]
a91891981: checks
Baksojor: checks
*** TURN *** [2c 4c 5c] [Tc]
a91891981: checks
Baksojor: checks
*** RIVER *** [2c 4c 5c Tc] [Ac]
a91891981: checks
Baksojor: checks
*** SHOW DOWN ***
a91891981: shows [Th Qs] (a flush, Ace high)
Baksojor: shows [Ad 6d] (a flush, Ace high)
a91891981 collected $0.15 from pot
Baksojor collected $0.15 from pot
*** SUMMARY ***
Total pot $0.31 | Rake $0.01
Board [2c 4c 5c Tc Ac]
Seat 1: 01R#tS (button) folded before Flop (didn't bet)
Seat 2: Shintaro327 (small blind) folded before Flop
Seat 3: IvaGold (big blind) folded before Flop
Seat 4: zaporozhko folded before Flop (didn't bet)
Seat 5: a91891981 showed [Th Qs] and won ($0.15) with a flush, Ace high
Seat 6: Baksojor showed [Ad 6d] and won ($0.15) with a flush, Ace high


*********** # 92 **************
PokerStars Zoom Hand #174065414689:  Hold'em No Limit ($0.02/$0.05) - 2017/08/08 10:46:31 MSK [2017/08/08 3:46:31 ET]
Table 'Donati' 6-max Seat #1 is the button
Seat 1: swesda21 ($5.02 in chips)
Seat 2: nitzed12 ($5.55 in chips)
Seat 3: Baksojor ($6.43 in chips)
Seat 4: Dasha_1989 ($5.12 in chips)
Seat 5: xerrorPL ($4.41 in chips)
Seat 6: b9nnsan ($5.06 in chips)
nitzed12: posts small blind $0.02
Baksojor: posts big blind $0.05
*** HOLE CARDS ***
Dealt to Baksojor [3s Ac]
Dasha_1989: raises $0.10 to $0.15
xerrorPL: folds
b9nnsan: folds
swesda21: calls $0.15
nitzed12: folds
Baksojor: folds
*** FLOP *** [Th Jc 3c]
Dasha_1989: bets $0.30
swesda21: calls $0.30
*** TURN *** [Th Jc 3c] [7c]
Dasha_1989: checks
swesda21: bets $0.65
Dasha_1989: calls $0.65
*** RIVER *** [Th Jc 3c 7c] [3h]
Dasha_1989: checks
swesda21: bets $1.90
Dasha_1989: calls $1.90
*** SHOW DOWN ***
swesda21: shows [Qs Ts] (two pair, Tens and Threes)
Dasha_1989: shows [As Ah] (two pair, Aces and Threes)
Dasha_1989 collected $5.82 from pot
*** SUMMARY ***
Total pot $6.07 | Rake $0.25
Board [Th Jc 3c 7c 3h]
Seat 1: swesda21 (button) showed [Qs Ts] and lost with two pair, Tens and Threes
Seat 2: nitzed12 (small blind) folded before Flop
Seat 3: Baksojor (big blind) folded before Flop
Seat 4: Dasha_1989 showed [As Ah] and won ($5.82) with two pair, Aces and Threes
Seat 5: xerrorPL folded before Flop (didn't bet)
Seat 6: b9nnsan folded before Flop (didn't bet)


*********** # 93 **************
PokerStars Zoom Hand #174065413339:  Hold'em No Limit ($0.02/$0.05) - 2017/08/08 10:46:26 MSK [2017/08/08 3:46:26 ET]
Table 'Donati' 6-max Seat #1 is the button
Seat 1: laurbogdy ($4.76 in chips)
Seat 2: rtleblanc ($1.72 in chips)
Seat 3: Zav989 ($6.25 in chips)
Seat 4: growingfish1 ($8.54 in chips)
Seat 5: Baksojor ($6.43 in chips)
Seat 6: pehtaras22 ($5.57 in chips)
rtleblanc: posts small blind $0.02
Zav989: posts big blind $0.05
*** HOLE CARDS ***
Dealt to Baksojor [Kc 5c]
growingfish1: folds
Baksojor: folds
pehtaras22: folds
laurbogdy: raises $0.10 to $0.15
rtleblanc: folds
Zav989: raises $0.32 to $0.47
laurbogdy: folds
Uncalled bet ($0.32) returned to Zav989
Zav989 collected $0.32 from pot
Zav989: doesn't show hand
*** SUMMARY ***
Total pot $0.32 | Rake $0
Seat 1: laurbogdy (button) folded before Flop
Seat 2: rtleblanc (small blind) folded before Flop
Seat 3: Zav989 (big blind) collected ($0.32)
Seat 4: growingfish1 folded before Flop (didn't bet)
Seat 5: Baksojor folded before Flop (didn't bet)
Seat 6: pehtaras22 folded before Flop (didn't bet)


*********** # 94 **************
PokerStars Zoom Hand #174065412257:  Hold'em No Limit ($0.02/$0.05) - 2017/08/08 10:46:22 MSK [2017/08/08 3:46:22 ET]
Table 'Donati' 6-max Seat #1 is the button
Seat 1: growingfish1 ($8.59 in chips)
Seat 2: JBatistaO ($6.37 in chips)
Seat 3: bigcue81 ($4.85 in chips)
Seat 4: Cartman 8703 ($5.79 in chips)
Seat 5: Baksojor ($6.43 in chips)
Seat 6: bajapple ($5.54 in chips)
JBatistaO: posts small blind $0.02
bigcue81: posts big blind $0.05
*** HOLE CARDS ***
Dealt to Baksojor [8d Kd]
Cartman 8703: folds
Baksojor: folds
bajapple: folds
growingfish1: raises $0.10 to $0.15
JBatistaO: calls $0.13
bigcue81: calls $0.10
*** FLOP *** [6s Jc Jd]
JBatistaO: checks
bigcue81: checks
growingfish1: bets $0.27
JBatistaO: folds
bigcue81: calls $0.27
*** TURN *** [6s Jc Jd] [Ks]
bigcue81: checks
growingfish1: checks
*** RIVER *** [6s Jc Jd Ks] [Ts]
bigcue81: bets $0.95
growingfish1: folds
Uncalled bet ($0.95) returned to bigcue81
bigcue81 collected $0.95 from pot
bigcue81: doesn't show hand
*** SUMMARY ***
Total pot $0.99 | Rake $0.04
Board [6s Jc Jd Ks Ts]
Seat 1: growingfish1 (button) folded on the River
Seat 2: JBatistaO (small blind) folded on the Flop
Seat 3: bigcue81 (big blind) collected ($0.95)
Seat 4: Cartman 8703 folded before Flop (didn't bet)
Seat 5: Baksojor folded before Flop (didn't bet)
Seat 6: bajapple folded before Flop (didn't bet)


*********** # 95 **************
PokerStars Zoom Hand #174065402884:  Hold'em No Limit ($0.02/$0.05) - 2017/08/08 10:45:47 MSK [2017/08/08 3:45:47 ET]
Table 'Donati' 6-max Seat #1 is the button
Seat 1: hiebsch87 ($5.77 in chips)
Seat 2: Baksojor ($5.38 in chips)
Seat 3: JBatistaO ($6.42 in chips)
Seat 4: antoxa oz ($5.33 in chips)
Seat 5: matos chuim ($2.25 in chips)
Seat 6: edi_jos_amos ($8.12 in chips)
Baksojor: posts small blind $0.02
JBatistaO: posts big blind $0.05
*** HOLE CARDS ***
Dealt to Baksojor [7s As]
antoxa oz: folds
matos chuim: folds
edi_jos_amos: folds
hiebsch87: raises $0.05 to $0.10
Baksojor: raises $0.30 to $0.40
JBatistaO: folds
hiebsch87: raises $0.60 to $1
Baksojor: raises $4.38 to $5.38 and is all-in
hiebsch87: folds
Uncalled bet ($4.38) returned to Baksojor
Baksojor collected $2.05 from pot
Baksojor: doesn't show hand
*** SUMMARY ***
Total pot $2.05 | Rake $0
Seat 1: hiebsch87 (button) folded before Flop
Seat 2: Baksojor (small blind) collected ($2.05)
Seat 3: JBatistaO (big blind) folded before Flop
Seat 4: antoxa oz folded before Flop (didn't bet)
Seat 5: matos chuim folded before Flop (didn't bet)
Seat 6: edi_jos_amos folded before Flop (didn't bet)


*********** # 96 **************
PokerStars Zoom Hand #174065401816:  Hold'em No Limit ($0.02/$0.05) - 2017/08/08 10:45:43 MSK [2017/08/08 3:45:43 ET]
Table 'Donati' 6-max Seat #1 is the button
Seat 1: Cartman 8703 ($5.65 in chips)
Seat 2: K1N3G3L69 ($6.70 in chips)
Seat 3: Brentyyy ($5 in chips)
Seat 4: Baksojor ($5.38 in chips)
Seat 5: jannsen84 ($5.08 in chips)
Seat 6: jimpoker1997 ($5.05 in chips)
K1N3G3L69: posts small blind $0.02
Brentyyy: posts big blind $0.05
*** HOLE CARDS ***
Dealt to Baksojor [8d 9c]
Baksojor: folds
jannsen84: folds
jimpoker1997: folds
Cartman 8703: raises $0.07 to $0.12
K1N3G3L69: calls $0.10
Brentyyy: folds
*** FLOP *** [Kh 9h 5s]
K1N3G3L69: checks
Cartman 8703: bets $0.15
K1N3G3L69: folds
Uncalled bet ($0.15) returned to Cartman 8703
Cartman 8703 collected $0.28 from pot
Cartman 8703: doesn't show hand
*** SUMMARY ***
Total pot $0.29 | Rake $0.01
Board [Kh 9h 5s]
Seat 1: Cartman 8703 (button) collected ($0.28)
Seat 2: K1N3G3L69 (small blind) folded on the Flop
Seat 3: Brentyyy (big blind) folded before Flop
Seat 4: Baksojor folded before Flop (didn't bet)
Seat 5: jannsen84 folded before Flop (didn't bet)
Seat 6: jimpoker1997 folded before Flop (didn't bet)


*********** # 97 **************
PokerStars Zoom Hand #174065395790:  Hold'em No Limit ($0.02/$0.05) - 2017/08/08 10:45:20 MSK [2017/08/08 3:45:20 ET]
Table 'Donati' 6-max Seat #1 is the button
Seat 1: Baksojor ($5.31 in chips)
Seat 2: reibejk ($5.29 in chips)
Seat 3: swesda21 ($5 in chips)
Seat 4: mnorde ($8.89 in chips)
Seat 5: nitzed12 ($5.16 in chips)
Seat 6: zen approach ($5.50 in chips)
reibejk: posts small blind $0.02
swesda21: posts big blind $0.05
*** HOLE CARDS ***
Dealt to Baksojor [Kh 6c]
mnorde: folds
nitzed12: folds
zen approach: folds
Baksojor: raises $0.05 to $0.10
reibejk: folds
swesda21: folds
Uncalled bet ($0.05) returned to Baksojor
Baksojor collected $0.12 from pot
Baksojor: doesn't show hand
*** SUMMARY ***
Total pot $0.12 | Rake $0
Seat 1: Baksojor (button) collected ($0.12)
Seat 2: reibejk (small blind) folded before Flop
Seat 3: swesda21 (big blind) folded before Flop
Seat 4: mnorde folded before Flop (didn't bet)
Seat 5: nitzed12 folded before Flop (didn't bet)
Seat 6: zen approach folded before Flop (didn't bet)


*********** # 98 **************
PokerStars Zoom Hand #174065392399:  Hold'em No Limit ($0.02/$0.05) - 2017/08/08 10:45:07 MSK [2017/08/08 3:45:07 ET]
Table 'Donati' 6-max Seat #1 is the button
Seat 1: JIuMuHTa ($12.51 in chips)
Seat 2: 4i4ogrob ($5.64 in chips)
Seat 3: rearmouse ($8.21 in chips)
Seat 4: RiVeRBeLoW98 ($11.72 in chips)
Seat 5: Eremka89 ($1.57 in chips)
Seat 6: Baksojor ($5.31 in chips)
4i4ogrob: posts small blind $0.02
rearmouse: posts big blind $0.05
*** HOLE CARDS ***
Dealt to Baksojor [7d 5h]
RiVeRBeLoW98: raises $0.07 to $0.12
Eremka89: calls $0.12
Baksojor: folds
JIuMuHTa: calls $0.12
4i4ogrob: folds
rearmouse: folds
*** FLOP *** [9h 9s 6h]
RiVeRBeLoW98: checks
Eremka89: checks
JIuMuHTa: checks
*** TURN *** [9h 9s 6h] [3s]
RiVeRBeLoW98: bets $0.26
Eremka89: folds
JIuMuHTa: folds
Uncalled bet ($0.26) returned to RiVeRBeLoW98
RiVeRBeLoW98 collected $0.41 from pot
RiVeRBeLoW98: doesn't show hand
*** SUMMARY ***
Total pot $0.43 | Rake $0.02
Board [9h 9s 6h 3s]
Seat 1: JIuMuHTa (button) folded on the Turn
Seat 2: 4i4ogrob (small blind) folded before Flop
Seat 3: rearmouse (big blind) folded before Flop
Seat 4: RiVeRBeLoW98 collected ($0.41)
Seat 5: Eremka89 folded on the Turn
Seat 6: Baksojor folded before Flop (didn't bet)


*********** # 99 **************
PokerStars Zoom Hand #174065387385:  Hold'em No Limit ($0.02/$0.05) - 2017/08/08 10:44:48 MSK [2017/08/08 3:44:48 ET]
Table 'Donati' 6-max Seat #1 is the button
Seat 1: calik81 ($6.16 in chips)
Seat 2: Jape60 ($5 in chips)
Seat 3: Baksojor ($5.36 in chips)
Seat 4: Dinara222 ($3.29 in chips)
Seat 5: MutbKa01 ($5.82 in chips)
Seat 6: SquirtleSquad ($7.41 in chips)
Jape60: posts small blind $0.02
Baksojor: posts big blind $0.05
*** HOLE CARDS ***
Dealt to Baksojor [9c 6h]
Dinara222: folds
MutbKa01: raises $0.10 to $0.15
SquirtleSquad: folds
calik81: folds
Jape60: folds
Baksojor: folds
Uncalled bet ($0.10) returned to MutbKa01
MutbKa01 collected $0.12 from pot
MutbKa01: doesn't show hand
*** SUMMARY ***
Total pot $0.12 | Rake $0
Seat 1: calik81 (button) folded before Flop (didn't bet)
Seat 2: Jape60 (small blind) folded before Flop
Seat 3: Baksojor (big blind) folded before Flop
Seat 4: Dinara222 folded before Flop (didn't bet)
Seat 5: MutbKa01 collected ($0.12)
Seat 6: SquirtleSquad folded before Flop (didn't bet)


*********** # 100 **************
PokerStars Zoom Hand #174065383936:  Hold'em No Limit ($0.02/$0.05) - 2017/08/08 10:44:35 MSK [2017/08/08 3:44:35 ET]
Table 'Donati' 6-max Seat #1 is the button
Seat 1: jimpoker1997 ($5.03 in chips)
Seat 2: Baksojor ($5.38 in chips)
Seat 3: edi_jos_amos ($7.93 in chips)
Seat 4: orcaraptor ($4.94 in chips)
Seat 5: kelevra__375 ($5.83 in chips)
Seat 6: reibejk ($6.93 in chips)
Baksojor: posts small blind $0.02
edi_jos_amos: posts big blind $0.05
*** HOLE CARDS ***
Dealt to Baksojor [7s 4c]
orcaraptor: folds
kelevra__375: folds
reibejk: folds
jimpoker1997: raises $0.05 to $0.10
Baksojor: folds
edi_jos_amos: calls $0.05
*** FLOP *** [7d Jc 9c]
edi_jos_amos: checks
jimpoker1997: bets $0.11
edi_jos_amos: raises $0.26 to $0.37
jimpoker1997: folds
Uncalled bet ($0.26) returned to edi_jos_amos
edi_jos_amos collected $0.42 from pot
edi_jos_amos: doesn't show hand
*** SUMMARY ***
Total pot $0.44 | Rake $0.02
Board [7d Jc 9c]
Seat 1: jimpoker1997 (button) folded on the Flop
Seat 2: Baksojor (small blind) folded before Flop
Seat 3: edi_jos_amos (big blind) collected ($0.42)
Seat 4: orcaraptor folded before Flop (didn't bet)
Seat 5: kelevra__375 folded before Flop (didn't bet)
Seat 6: reibejk folded before Flop (didn't bet)


*********** # 101 **************
PokerStars Zoom Hand #174065370005:  Hold'em No Limit ($0.02/$0.05) - 2017/08/08 10:43:42 MSK [2017/08/08 3:43:42 ET]
Table 'Donati' 6-max Seat #1 is the button
Seat 1: TrotiLo ($6.54 in chips)
Seat 2: svenev ($6.11 in chips)
Seat 3: Sita1986 ($11.18 in chips)
Seat 4: Baksojor ($5.07 in chips)
Seat 5: RIchNOobik ($6.60 in chips)
Seat 6: hunnybun888 ($7.01 in chips)
svenev: posts small blind $0.02
Sita1986: posts big blind $0.05
*** HOLE CARDS ***
Dealt to Baksojor [Qc Kd]
Baksojor: raises $0.10 to $0.15
RIchNOobik: folds
hunnybun888: folds
TrotiLo: folds
svenev: folds
Sita1986: calls $0.10
*** FLOP *** [Kc 7c 3s]
Sita1986: checks
Baksojor: checks
*** TURN *** [Kc 7c 3s] [6c]
Sita1986: bets $0.17
Baksojor: calls $0.17
*** RIVER *** [Kc 7c 3s 6c] [Td]
Sita1986: checks
Baksojor: bets $0.42
Sita1986: folds
Uncalled bet ($0.42) returned to Baksojor
Baksojor collected $0.63 from pot
Baksojor: doesn't show hand
*** SUMMARY ***
Total pot $0.66 | Rake $0.03
Board [Kc 7c 3s 6c Td]
Seat 1: TrotiLo (button) folded before Flop (didn't bet)
Seat 2: svenev (small blind) folded before Flop
Seat 3: Sita1986 (big blind) folded on the River
Seat 4: Baksojor collected ($0.63)
Seat 5: RIchNOobik folded before Flop (didn't bet)
Seat 6: hunnybun888 folded before Flop (didn't bet)


*********** # 102 **************
PokerStars Zoom Hand #174065366809:  Hold'em No Limit ($0.02/$0.05) - 2017/08/08 10:43:30 MSK [2017/08/08 3:43:30 ET]
Table 'Donati' 6-max Seat #1 is the button
Seat 1: Halaa16 ($9.87 in chips)
Seat 2: ppbbrat ($5.70 in chips)
Seat 3: 1000G's ($8.30 in chips)
Seat 4: Alexandro670 ($1.89 in chips)
Seat 5: Baksojor ($5 in chips)
Seat 6: a91891981 ($6.31 in chips)
ppbbrat: posts small blind $0.02
1000G's: posts big blind $0.05
*** HOLE CARDS ***
Dealt to Baksojor [4h Ah]
Alexandro670: folds
Baksojor: raises $0.10 to $0.15
a91891981: folds
Halaa16: folds
ppbbrat: folds
1000G's: folds
Uncalled bet ($0.10) returned to Baksojor
Baksojor collected $0.12 from pot
Baksojor: doesn't show hand
*** SUMMARY ***
Total pot $0.12 | Rake $0
Seat 1: Halaa16 (button) folded before Flop (didn't bet)
Seat 2: ppbbrat (small blind) folded before Flop
Seat 3: 1000G's (big blind) folded before Flop
Seat 4: Alexandro670 folded before Flop (didn't bet)
Seat 5: Baksojor collected ($0.12)
Seat 6: a91891981 folded before Flop (didn't bet)


*********** # 103 **************
PokerStars Zoom Hand #174065356042:  Hold'em No Limit ($0.02/$0.05) - 2017/08/08 10:42:49 MSK [2017/08/08 3:42:49 ET]
Table 'Donati' 6-max Seat #1 is the button
Seat 1: mmbuxtehude ($5.05 in chips)
Seat 2: koshi712 ($5 in chips)
Seat 3: Bisi6611 ($5.12 in chips)
Seat 4: xerrorPL ($6.17 in chips)
Seat 5: j18010030 ($7.11 in chips)
Seat 6: Baksojor ($5.37 in chips)
koshi712: posts small blind $0.02
Bisi6611: posts big blind $0.05
*** HOLE CARDS ***
Dealt to Baksojor [Qd Jd]
xerrorPL: folds
j18010030: folds
Baksojor: raises $0.07 to $0.12
mmbuxtehude: calls $0.12
koshi712: folds
Bisi6611: folds
*** FLOP *** [5c 8d 4c]
Baksojor: bets $0.20
mmbuxtehude: calls $0.20
*** TURN *** [5c 8d 4c] [Tc]
Baksojor: bets $0.45
mmbuxtehude: raises $0.79 to $1.24
Baksojor: folds
Uncalled bet ($0.79) returned to mmbuxtehude
mmbuxtehude collected $1.54 from pot
mmbuxtehude: doesn't show hand
*** SUMMARY ***
Total pot $1.61 | Rake $0.07
Board [5c 8d 4c Tc]
Seat 1: mmbuxtehude (button) collected ($1.54)
Seat 2: koshi712 (small blind) folded before Flop
Seat 3: Bisi6611 (big blind) folded before Flop
Seat 4: xerrorPL folded before Flop (didn't bet)
Seat 5: j18010030 folded before Flop (didn't bet)
Seat 6: Baksojor folded on the Turn


*********** # 104 **************
PokerStars Zoom Hand #174065353022:  Hold'em No Limit ($0.02/$0.05) - 2017/08/08 10:42:37 MSK [2017/08/08 3:42:37 ET]
Table 'Donati' 6-max Seat #1 is the button
Seat 1: Baksojor ($5.37 in chips)
Seat 2: mnorde ($5.64 in chips)
Seat 3: pipecmolodec ($5.05 in chips)
Seat 4: swesda21 ($6.94 in chips)
Seat 5: Brentyyy ($9.99 in chips)
Seat 6: Cartman 8703 ($6.53 in chips)
mnorde: posts small blind $0.02
pipecmolodec: posts big blind $0.05
*** HOLE CARDS ***
Dealt to Baksojor [7c Kc]
swesda21: raises $0.10 to $0.15
Brentyyy: folds
Cartman 8703: folds
Baksojor: folds
mnorde: folds
pipecmolodec: folds
Uncalled bet ($0.10) returned to swesda21
swesda21 collected $0.12 from pot
swesda21: doesn't show hand
*** SUMMARY ***
Total pot $0.12 | Rake $0
Seat 1: Baksojor (button) folded before Flop (didn't bet)
Seat 2: mnorde (small blind) folded before Flop
Seat 3: pipecmolodec (big blind) folded before Flop
Seat 4: swesda21 collected ($0.12)
Seat 5: Brentyyy folded before Flop (didn't bet)
Seat 6: Cartman 8703 folded before Flop (didn't bet)


*********** # 105 **************
PokerStars Zoom Hand #174065345749:  Hold'em No Limit ($0.02/$0.05) - 2017/08/08 10:42:09 MSK [2017/08/08 3:42:09 ET]
Table 'Donati' 6-max Seat #1 is the button
Seat 1: jimpoker1997 ($6.68 in chips)
Seat 2: DrD.Phoenix ($5.89 in chips)
Seat 3: Baksojor ($5.35 in chips)
Seat 4: IvaGold ($12.42 in chips)
Seat 5: 1000G's ($8.23 in chips)
Seat 6: tsukikuu ($8.61 in chips)
DrD.Phoenix: posts small blind $0.02
Baksojor: posts big blind $0.05
*** HOLE CARDS ***
Dealt to Baksojor [7c 5c]
IvaGold: folds
1000G's: folds
tsukikuu: folds
jimpoker1997: folds
DrD.Phoenix: folds
Uncalled bet ($0.03) returned to Baksojor
Baksojor collected $0.04 from pot
Baksojor: doesn't show hand
*** SUMMARY ***
Total pot $0.04 | Rake $0
Seat 1: jimpoker1997 (button) folded before Flop (didn't bet)
Seat 2: DrD.Phoenix (small blind) folded before Flop
Seat 3: Baksojor (big blind) collected ($0.04)
Seat 4: IvaGold folded before Flop (didn't bet)
Seat 5: 1000G's folded before Flop (didn't bet)
Seat 6: tsukikuu folded before Flop (didn't bet)


*********** # 106 **************
PokerStars Zoom Hand #174065332312:  Hold'em No Limit ($0.02/$0.05) - 2017/08/08 10:41:16 MSK [2017/08/08 3:41:16 ET]
Table 'Donati' 6-max Seat #1 is the button
Seat 1: j18010030 ($7.05 in chips)
Seat 2: Baksojor ($5.02 in chips)
Seat 3: hullujussi85 ($8.02 in chips)
Seat 4: borntamer ($5.70 in chips)
Seat 5: sportivnii ($5 in chips)
Seat 6: rearmouse ($5.09 in chips)
Baksojor: posts small blind $0.02
hullujussi85: posts big blind $0.05
*** HOLE CARDS ***
Dealt to Baksojor [Ad Jh]
borntamer: raises $0.10 to $0.15
sportivnii: calls $0.15
rearmouse: folds
j18010030: folds
Baksojor: calls $0.13
hullujussi85: folds
*** FLOP *** [9h Qs 2h]
Baksojor: checks
borntamer: checks
sportivnii: checks
*** TURN *** [9h Qs 2h] [As]
Baksojor: bets $0.30
borntamer: folds
sportivnii: folds
Uncalled bet ($0.30) returned to Baksojor
Baksojor collected $0.48 from pot
Baksojor: doesn't show hand
*** SUMMARY ***
Total pot $0.50 | Rake $0.02
Board [9h Qs 2h As]
Seat 1: j18010030 (button) folded before Flop (didn't bet)
Seat 2: Baksojor (small blind) collected ($0.48)
Seat 3: hullujussi85 (big blind) folded before Flop
Seat 4: borntamer folded on the Turn
Seat 5: sportivnii folded on the Turn
Seat 6: rearmouse folded before Flop (didn't bet)


*********** # 107 **************
PokerStars Zoom Hand #174065328745:  Hold'em No Limit ($0.02/$0.05) - 2017/08/08 10:41:02 MSK [2017/08/08 3:41:02 ET]
Table 'Donati' 6-max Seat #1 is the button
Seat 1: Baksojor ($5.02 in chips)
Seat 2: jimpoker1997 ($6.87 in chips)
Seat 3: Evetrin ($5 in chips)
Seat 4: Barny1988 ($2.60 in chips)
Seat 5: antoxa oz ($6.78 in chips)
Seat 6: pokermagik46 ($5.07 in chips)
jimpoker1997: posts small blind $0.02
Evetrin: posts big blind $0.05
*** HOLE CARDS ***
Dealt to Baksojor [As 2d]
Barny1988: folds
antoxa oz: raises $0.05 to $0.10
pokermagik46: folds
Baksojor: folds
jimpoker1997: calls $0.08
Evetrin: calls $0.05
*** FLOP *** [Td 7h 5d]
jimpoker1997: checks
Evetrin: checks
antoxa oz: checks
*** TURN *** [Td 7h 5d] [Ad]
jimpoker1997: checks
Evetrin: checks
antoxa oz: checks
*** RIVER *** [Td 7h 5d Ad] [8c]
jimpoker1997: checks
Evetrin: checks
antoxa oz: checks
*** SHOW DOWN ***
jimpoker1997: shows [6s 6d] (a pair of Sixes)
Evetrin: mucks hand
antoxa oz: shows [7c 6c] (a pair of Sevens)
antoxa oz collected $0.29 from pot
*** SUMMARY ***
Total pot $0.30 | Rake $0.01
Board [Td 7h 5d Ad 8c]
Seat 1: Baksojor (button) folded before Flop (didn't bet)
Seat 2: jimpoker1997 (small blind) showed [6s 6d] and lost with a pair of Sixes
Seat 3: Evetrin (big blind) mucked [5c Kc]
Seat 4: Barny1988 folded before Flop (didn't bet)
Seat 5: antoxa oz showed [7c 6c] and won ($0.29) with a pair of Sevens
Seat 6: pokermagik46 folded before Flop (didn't bet)


*********** # 108 **************
PokerStars Zoom Hand #174065327434:  Hold'em No Limit ($0.02/$0.05) - 2017/08/08 10:40:57 MSK [2017/08/08 3:40:57 ET]
Table 'Donati' 6-max Seat #1 is the button
Seat 1: hiebsch87 ($5.93 in chips)
Seat 2: JBatistaO ($7.92 in chips)
Seat 3: petokrcmar ($2.25 in chips)
Seat 4: Baksojor ($5.02 in chips)
Seat 5: MResetM ($5.48 in chips)
Seat 6: Astour194 ($5.15 in chips)
JBatistaO: posts small blind $0.02
petokrcmar: posts big blind $0.05
*** HOLE CARDS ***
Dealt to Baksojor [2d 7h]
Baksojor: folds
MResetM: folds
Astour194: raises $0.08 to $0.13
hiebsch87: folds
JBatistaO: folds
petokrcmar: folds
Uncalled bet ($0.08) returned to Astour194
Astour194 collected $0.12 from pot
Astour194: doesn't show hand
*** SUMMARY ***
Total pot $0.12 | Rake $0
Seat 1: hiebsch87 (button) folded before Flop (didn't bet)
Seat 2: JBatistaO (small blind) folded before Flop
Seat 3: petokrcmar (big blind) folded before Flop
Seat 4: Baksojor folded before Flop (didn't bet)
Seat 5: MResetM folded before Flop (didn't bet)
Seat 6: Astour194 collected ($0.12)


*********** # 109 **************
PokerStars Zoom Hand #174065324027:  Hold'em No Limit ($0.02/$0.05) - 2017/08/08 10:40:44 MSK [2017/08/08 3:40:44 ET]
Table 'Donati' 6-max Seat #1 is the button
Seat 1: j18010030 ($7.03 in chips)
Seat 2: svenev ($6.50 in chips)
Seat 3: Baksojor ($5 in chips)
Seat 4: hiebsch87 ($5.53 in chips)
Seat 5: Brentyyy ($10.06 in chips)
Seat 6: Evetrin ($5.20 in chips)
svenev: posts small blind $0.02
Baksojor: posts big blind $0.05
*** HOLE CARDS ***
Dealt to Baksojor [9h 8d]
hiebsch87: folds
Brentyyy: folds
Evetrin: folds
j18010030: folds
svenev: folds
Uncalled bet ($0.03) returned to Baksojor
Baksojor collected $0.04 from pot
Baksojor: doesn't show hand
*** SUMMARY ***
Total pot $0.04 | Rake $0
Seat 1: j18010030 (button) folded before Flop (didn't bet)
Seat 2: svenev (small blind) folded before Flop
Seat 3: Baksojor (big blind) collected ($0.04)
Seat 4: hiebsch87 folded before Flop (didn't bet)
Seat 5: Brentyyy folded before Flop (didn't bet)
Seat 6: Evetrin folded before Flop (didn't bet)


*********** # 110 **************
PokerStars Zoom Hand #174065322289:  Hold'em No Limit ($0.02/$0.05) - 2017/08/08 10:40:37 MSK [2017/08/08 3:40:37 ET]
Table 'Donati' 6-max Seat #1 is the button
Seat 1: 01R#tS ($5.93 in chips)
Seat 2: JBatistaO ($5.04 in chips)
Seat 3: n.lightman ($2.50 in chips)
Seat 4: TeddyTaiwan ($5.10 in chips)
Seat 5: Baksojor ($5 in chips)
Seat 6: SquirtleSquad ($5.11 in chips)
JBatistaO: posts small blind $0.02
n.lightman: posts big blind $0.05
*** HOLE CARDS ***
Dealt to Baksojor [7d 9c]
TeddyTaiwan: folds
Baksojor: folds
SquirtleSquad: folds
01R#tS: raises $0.05 to $0.10
JBatistaO: folds
n.lightman: folds
Uncalled bet ($0.05) returned to 01R#tS
01R#tS collected $0.12 from pot
01R#tS: doesn't show hand
*** SUMMARY ***
Total pot $0.12 | Rake $0
Seat 1: 01R#tS (button) collected ($0.12)
Seat 2: JBatistaO (small blind) folded before Flop
Seat 3: n.lightman (big blind) folded before Flop
Seat 4: TeddyTaiwan folded before Flop (didn't bet)
Seat 5: Baksojor folded before Flop (didn't bet)
Seat 6: SquirtleSquad folded before Flop (didn't bet)


*********** # 111 **************
PokerStars Zoom Hand #174065320766:  Hold'em No Limit ($0.02/$0.05) - 2017/08/08 10:40:31 MSK [2017/08/08 3:40:31 ET]
Table 'Donati' 6-max Seat #1 is the button
Seat 1: edi_jos_amos ($6.96 in chips)
Seat 2: matos chuim ($2.45 in chips)
Seat 3: RIchNOobik ($6.13 in chips)
Seat 4: Baksojor ($5 in chips)
Seat 5: xerrorPL ($6.01 in chips)
Seat 6: freekidwei ($5.23 in chips)
matos chuim: posts small blind $0.02
RIchNOobik: posts big blind $0.05
*** HOLE CARDS ***
Dealt to Baksojor [8h Jc]
Baksojor: folds
xerrorPL: folds
freekidwei: raises $0.10 to $0.15
edi_jos_amos: folds
matos chuim: calls $0.13
RIchNOobik: raises $0.50 to $0.65
freekidwei: folds
matos chuim: folds
Uncalled bet ($0.50) returned to RIchNOobik
RIchNOobik collected $0.45 from pot
RIchNOobik: doesn't show hand
*** SUMMARY ***
Total pot $0.45 | Rake $0
Seat 1: edi_jos_amos (button) folded before Flop (didn't bet)
Seat 2: matos chuim (small blind) folded before Flop
Seat 3: RIchNOobik (big blind) collected ($0.45)
Seat 4: Baksojor folded before Flop (didn't bet)
Seat 5: xerrorPL folded before Flop (didn't bet)
Seat 6: freekidwei folded before Flop


*********** # 112 **************
PokerStars Zoom Hand #174065317970:  Hold'em No Limit ($0.02/$0.05) - 2017/08/08 10:40:20 MSK [2017/08/08 3:40:20 ET]
Table 'Donati' 6-max Seat #1 is the button
Seat 1: petokrcmar ($2.08 in chips)
Seat 2: Baksojor ($5 in chips)
Seat 3: xerrorPL ($5.13 in chips)
Seat 4: swesda21 ($5.37 in chips)
Seat 5: matos chuim ($2.45 in chips)
Seat 6: RIchNOobik ($17.58 in chips)
Baksojor: posts small blind $0.02
xerrorPL: posts big blind $0.05
*** HOLE CARDS ***
Dealt to Baksojor [9h Js]
swesda21: folds
matos chuim: folds
RIchNOobik: raises $0.10 to $0.15
petokrcmar: folds
Baksojor: folds
xerrorPL: folds
Uncalled bet ($0.10) returned to RIchNOobik
RIchNOobik collected $0.12 from pot
RIchNOobik: doesn't show hand
*** SUMMARY ***
Total pot $0.12 | Rake $0
Seat 1: petokrcmar (button) folded before Flop (didn't bet)
Seat 2: Baksojor (small blind) folded before Flop
Seat 3: xerrorPL (big blind) folded before Flop
Seat 4: swesda21 folded before Flop (didn't bet)
Seat 5: matos chuim folded before Flop (didn't bet)
Seat 6: RIchNOobik collected ($0.12)


*********** # 113 **************
PokerStars Zoom Hand #174065316944:  Hold'em No Limit ($0.02/$0.05) - 2017/08/08 10:40:16 MSK [2017/08/08 3:40:16 ET]
Table 'Donati' 6-max Seat #1 is the button
Seat 1: YurbanKaban ($5.71 in chips)
Seat 2: simple s0o ($6.95 in chips)
Seat 3: LaMahiala ($5.31 in chips)
Seat 4: mnorde ($9.37 in chips)
Seat 5: Baksojor ($5 in chips)
Seat 6: wurb ($8.09 in chips)
simple s0o: posts small blind $0.02
LaMahiala: posts big blind $0.05
*** HOLE CARDS ***
Dealt to Baksojor [2c 7s]
mnorde: folds
Baksojor: folds
wurb: raises $0.10 to $0.15
YurbanKaban: folds
simple s0o: folds
LaMahiala: folds
Uncalled bet ($0.10) returned to wurb
wurb collected $0.12 from pot
wurb: doesn't show hand
*** SUMMARY ***
Total pot $0.12 | Rake $0
Seat 1: YurbanKaban (button) folded before Flop (didn't bet)
Seat 2: simple s0o (small blind) folded before Flop
Seat 3: LaMahiala (big blind) folded before Flop
Seat 4: mnorde folded before Flop (didn't bet)
Seat 5: Baksojor folded before Flop (didn't bet)
Seat 6: wurb collected ($0.12)


*********** # 114 **************
PokerStars Zoom Hand #174065313608:  Hold'em No Limit ($0.02/$0.05) - 2017/08/08 10:40:03 MSK [2017/08/08 3:40:03 ET]
Table 'Donati' 6-max Seat #1 is the button
Seat 1: Baksojor ($5 in chips)
Seat 2: koshi712 ($6.08 in chips)
Seat 3: growingfish1 ($9.36 in chips)
Seat 4: TeddyTaiwan ($5.53 in chips)
Seat 5: RIchNOobik ($27.51 in chips)
Seat 6: fidelmp ($6.98 in chips)
koshi712: posts small blind $0.02
growingfish1: posts big blind $0.05
*** HOLE CARDS ***
Dealt to Baksojor [4h 7h]
TeddyTaiwan: folds
RIchNOobik: folds
fidelmp: raises $0.12 to $0.17
Baksojor: folds
koshi712: folds
growingfish1: folds
Uncalled bet ($0.12) returned to fidelmp
fidelmp collected $0.12 from pot
fidelmp: doesn't show hand
*** SUMMARY ***
Total pot $0.12 | Rake $0
Seat 1: Baksojor (button) folded before Flop (didn't bet)
Seat 2: koshi712 (small blind) folded before Flop
Seat 3: growingfish1 (big blind) folded before Flop
Seat 4: TeddyTaiwan folded before Flop (didn't bet)
Seat 5: RIchNOobik folded before Flop (didn't bet)
Seat 6: fidelmp collected ($0.12)


*********** # 115 **************
PokerStars Zoom Hand #174065312305:  Hold'em No Limit ($0.02/$0.05) - 2017/08/08 10:39:58 MSK [2017/08/08 3:39:58 ET]
Table 'Donati' 6-max Seat #1 is the button
Seat 1: toll197 ($6.81 in chips)
Seat 2: xerrorPL ($5.58 in chips)
Seat 3: borntamer ($5.94 in chips)
Seat 4: birdieputt18 ($8.61 in chips)
Seat 5: wurb ($6.66 in chips)
Seat 6: Baksojor ($5 in chips)
xerrorPL: posts small blind $0.02
borntamer: posts big blind $0.05
*** HOLE CARDS ***
Dealt to Baksojor [2h 4h]
birdieputt18: folds
wurb: raises $0.10 to $0.15
Baksojor: folds
toll197: folds
xerrorPL: folds
borntamer: folds
Uncalled bet ($0.10) returned to wurb
wurb collected $0.12 from pot
wurb: doesn't show hand
*** SUMMARY ***
Total pot $0.12 | Rake $0
Seat 1: toll197 (button) folded before Flop (didn't bet)
Seat 2: xerrorPL (small blind) folded before Flop
Seat 3: borntamer (big blind) folded before Flop
Seat 4: birdieputt18 folded before Flop (didn't bet)
Seat 5: wurb collected ($0.12)
Seat 6: Baksojor folded before Flop (didn't bet)


*********** # 116 **************
PokerStars Zoom Hand #174065308113:  Hold'em No Limit ($0.02/$0.05) - 2017/08/08 10:39:42 MSK [2017/08/08 3:39:42 ET]
Table 'Donati' 6-max Seat #1 is the button
Seat 1: honeyjon ($7.60 in chips)
Seat 2: Baksojor ($5 in chips)
Seat 3: orcaraptor ($4.86 in chips)
Seat 4: jolly jono ($9.88 in chips)
Seat 5: thiusk ($5.58 in chips)
Seat 6: 1disuda ($10.48 in chips)
Baksojor: posts small blind $0.02
orcaraptor: posts big blind $0.05
*** HOLE CARDS ***
Dealt to Baksojor [Ac 8h]
jolly jono: folds
thiusk: folds
1disuda: raises $0.10 to $0.15
honeyjon: folds
Baksojor: folds
orcaraptor: folds
Uncalled bet ($0.10) returned to 1disuda
1disuda collected $0.12 from pot
1disuda: doesn't show hand
*** SUMMARY ***
Total pot $0.12 | Rake $0
Seat 1: honeyjon (button) folded before Flop (didn't bet)
Seat 2: Baksojor (small blind) folded before Flop
Seat 3: orcaraptor (big blind) folded before Flop
Seat 4: jolly jono folded before Flop (didn't bet)
Seat 5: thiusk folded before Flop (didn't bet)
Seat 6: 1disuda collected ($0.12)


*********** # 117 **************
PokerStars Zoom Hand #174065305789:  Hold'em No Limit ($0.02/$0.05) - 2017/08/08 10:39:33 MSK [2017/08/08 3:39:33 ET]
Table 'Donati' 6-max Seat #1 is the button
Seat 1: EmariaD ($5.78 in chips)
Seat 2: xerrorPL ($5.22 in chips)
Seat 3: Baksojor ($5 in chips)
Seat 4: antoxa oz ($5 in chips)
Seat 5: rearmouse ($5.79 in chips)
Seat 6: HighRaider ($5 in chips)
xerrorPL: posts small blind $0.02
Baksojor: posts big blind $0.05
*** HOLE CARDS ***
Dealt to Baksojor [3h 2d]
antoxa oz: folds
rearmouse: folds
HighRaider: raises $0.07 to $0.12
EmariaD: folds
xerrorPL: folds
Baksojor: folds
Uncalled bet ($0.07) returned to HighRaider
HighRaider collected $0.12 from pot
HighRaider: doesn't show hand
*** SUMMARY ***
Total pot $0.12 | Rake $0
Seat 1: EmariaD (button) folded before Flop (didn't bet)
Seat 2: xerrorPL (small blind) folded before Flop
Seat 3: Baksojor (big blind) folded before Flop
Seat 4: antoxa oz folded before Flop (didn't bet)
Seat 5: rearmouse folded before Flop (didn't bet)
Seat 6: HighRaider collected ($0.12)


*********** # 118 **************
PokerStars Zoom Hand #174065304484:  Hold'em No Limit ($0.02/$0.05) - 2017/08/08 10:39:28 MSK [2017/08/08 3:39:28 ET]
Table 'Donati' 6-max Seat #1 is the button
Seat 1: growingfish1 ($14.78 in chips)
Seat 2: SpecialForMe ($8.36 in chips)
Seat 3: Cartman 8703 ($6.62 in chips)
Seat 4: Baksojor ($5 in chips)
Seat 5: kita8444 ($9 in chips)
Seat 6: umair01982 ($5.97 in chips)
SpecialForMe: posts small blind $0.02
Cartman 8703: posts big blind $0.05
*** HOLE CARDS ***
Dealt to Baksojor [Ac 3d]
Baksojor: folds
kita8444: folds
umair01982: folds
growingfish1: raises $0.10 to $0.15
SpecialForMe: folds
Cartman 8703: folds
Uncalled bet ($0.10) returned to growingfish1
growingfish1 collected $0.12 from pot
growingfish1: doesn't show hand
*** SUMMARY ***
Total pot $0.12 | Rake $0
Seat 1: growingfish1 (button) collected ($0.12)
Seat 2: SpecialForMe (small blind) folded before Flop
Seat 3: Cartman 8703 (big blind) folded before Flop
Seat 4: Baksojor folded before Flop (didn't bet)
Seat 5: kita8444 folded before Flop (didn't bet)
Seat 6: umair01982 folded before Flop (didn't bet)


*********** # 119 **************
PokerStars Zoom Hand #174065303231:  Hold'em No Limit ($0.02/$0.05) - 2017/08/08 10:39:23 MSK [2017/08/08 3:39:23 ET]
Table 'Donati' 6-max Seat #1 is the button
Seat 1: mnorde ($9.44 in chips)
Seat 2: pehtaras22 ($10.76 in chips)
Seat 3: Dennys27 ($3.01 in chips)
Seat 4: V.S.151 ($6.30 in chips)
Seat 5: Baksojor ($5 in chips)
Seat 6: ALEX567967 ($5.37 in chips)
pehtaras22: posts small blind $0.02
Dennys27: posts big blind $0.05
*** HOLE CARDS ***
Dealt to Baksojor [6c 2s]
V.S.151: folds
Baksojor: folds
ALEX567967: folds
mnorde: folds
pehtaras22: folds
Uncalled bet ($0.03) returned to Dennys27
Dennys27 collected $0.04 from pot
Dennys27: doesn't show hand
*** SUMMARY ***
Total pot $0.04 | Rake $0
Seat 1: mnorde (button) folded before Flop (didn't bet)
Seat 2: pehtaras22 (small blind) folded before Flop
Seat 3: Dennys27 (big blind) collected ($0.04)
Seat 4: V.S.151 folded before Flop (didn't bet)
Seat 5: Baksojor folded before Flop (didn't bet)
Seat 6: ALEX567967 folded before Flop (didn't bet)


*********** # 120 **************
PokerStars Zoom Hand #174065301359:  Hold'em No Limit ($0.02/$0.05) - 2017/08/08 10:39:16 MSK [2017/08/08 3:39:16 ET]
Table 'Donati' 6-max Seat #1 is the button
Seat 1: Shintaro327 ($4.99 in chips)
Seat 2: borntamer ($7.72 in chips)
Seat 3: zen approach ($6.02 in chips)
Seat 4: rdavek ($5.82 in chips)
Seat 5: koshi712 ($6.06 in chips)
Seat 6: Baksojor ($5 in chips)
borntamer: posts small blind $0.02
zen approach: posts big blind $0.05
*** HOLE CARDS ***
Dealt to Baksojor [3s Qs]
rdavek: folds
koshi712: folds
Baksojor: folds
Shintaro327: raises $0.07 to $0.12
borntamer: folds
zen approach: folds
Uncalled bet ($0.07) returned to Shintaro327
Shintaro327 collected $0.12 from pot
Shintaro327: doesn't show hand
*** SUMMARY ***
Total pot $0.12 | Rake $0
Seat 1: Shintaro327 (button) collected ($0.12)
Seat 2: borntamer (small blind) folded before Flop
Seat 3: zen approach (big blind) folded before Flop
Seat 4: rdavek folded before Flop (didn't bet)
Seat 5: koshi712 folded before Flop (didn't bet)
Seat 6: Baksojor folded before Flop (didn't bet)


*********** # 121 **************
PokerStars Zoom Hand #174065298508:  Hold'em No Limit ($0.02/$0.05) - 2017/08/08 10:39:05 MSK [2017/08/08 3:39:05 ET]
Table 'Donati' 6-max Seat #1 is the button
Seat 1: Baksojor ($5 in chips)
Seat 2: 1disuda ($6.61 in chips)
Seat 3: Luettefee ($4.22 in chips)
Seat 4: simple s0o ($5.41 in chips)
Seat 5: okipoky ($4.79 in chips)
Seat 6: joaquindela ($5.58 in chips)
1disuda: posts small blind $0.02
Luettefee: posts big blind $0.05
*** HOLE CARDS ***
Dealt to Baksojor [2c Td]
simple s0o: raises $0.10 to $0.15
okipoky: folds
joaquindela: folds
Baksojor: folds
1disuda: folds
Luettefee: folds
Uncalled bet ($0.10) returned to simple s0o
simple s0o collected $0.12 from pot
simple s0o: doesn't show hand
*** SUMMARY ***
Total pot $0.12 | Rake $0
Seat 1: Baksojor (button) folded before Flop (didn't bet)
Seat 2: 1disuda (small blind) folded before Flop
Seat 3: Luettefee (big blind) folded before Flop
Seat 4: simple s0o collected ($0.12)
Seat 5: okipoky folded before Flop (didn't bet)
Seat 6: joaquindela folded before Flop (didn't bet)


*********** # 122 **************
PokerStars Zoom Hand #174065297256:  Hold'em No Limit ($0.02/$0.05) - 2017/08/08 10:39:00 MSK [2017/08/08 3:39:00 ET]
Table 'Donati' 6-max Seat #1 is the button
Seat 1: Ginternet12 ($7.81 in chips)
Seat 2: svenev ($6.95 in chips)
Seat 3: rdavek ($10.85 in chips)
Seat 4: Baksojor ($5 in chips)
Seat 5: BenHKN ($5.58 in chips)
Seat 6: romanshepp ($5.18 in chips)
svenev: posts small blind $0.02
rdavek: posts big blind $0.05
*** HOLE CARDS ***
Dealt to Baksojor [2h 8s]
Baksojor: folds
BenHKN: folds
romanshepp: folds
Ginternet12: raises $0.10 to $0.15
svenev: folds
rdavek: calls $0.10
*** FLOP *** [Jd 6d 4h]
rdavek: checks
Ginternet12: bets $0.16
rdavek: calls $0.16
*** TURN *** [Jd 6d 4h] [Th]
rdavek: bets $0.40
Ginternet12: folds
Uncalled bet ($0.40) returned to rdavek
rdavek collected $0.61 from pot
rdavek: doesn't show hand
*** SUMMARY ***
Total pot $0.64 | Rake $0.03
Board [Jd 6d 4h Th]
Seat 1: Ginternet12 (button) folded on the Turn
Seat 2: svenev (small blind) folded before Flop
Seat 3: rdavek (big blind) collected ($0.61)
Seat 4: Baksojor folded before Flop (didn't bet)
Seat 5: BenHKN folded before Flop (didn't bet)
Seat 6: romanshepp folded before Flop (didn't bet)


*********** # 123 **************
PokerStars Zoom Hand #174065296233:  Hold'em No Limit ($0.02/$0.05) - 2017/08/08 10:38:56 MSK [2017/08/08 3:38:56 ET]
Table 'Donati' 6-max Seat #1 is the button
Seat 1: DrD.Phoenix ($5.61 in chips)
Seat 2: Baksojor ($5 in chips)
Seat 3: akakios1 ($3.92 in chips)
Seat 4: ilsol ($10.35 in chips)
Seat 5: romanshepp ($5.18 in chips)
Seat 6: Smokemk3 ($32.63 in chips)
Baksojor: posts small blind $0.02
akakios1: posts big blind $0.05
*** HOLE CARDS ***
Dealt to Baksojor [4d 3c]
ilsol: raises $0.10 to $0.15
romanshepp: folds
Smokemk3: folds
DrD.Phoenix: folds
Baksojor: folds
akakios1: folds
Uncalled bet ($0.10) returned to ilsol
ilsol collected $0.12 from pot
ilsol: doesn't show hand
*** SUMMARY ***
Total pot $0.12 | Rake $0
Seat 1: DrD.Phoenix (button) folded before Flop (didn't bet)
Seat 2: Baksojor (small blind) folded before Flop
Seat 3: akakios1 (big blind) folded before Flop
Seat 4: ilsol collected ($0.12)
Seat 5: romanshepp folded before Flop (didn't bet)
Seat 6: Smokemk3 folded before Flop (didn't bet)


*********** # 124 **************
PokerStars Zoom Hand #174065292920:  Hold'em No Limit ($0.02/$0.05) - 2017/08/08 10:38:43 MSK [2017/08/08 3:38:43 ET]
Table 'Donati' 6-max Seat #1 is the button
Seat 1: 1000G's ($4.74 in chips)
Seat 2: a91891981 ($10.50 in chips)
Seat 3: Baksojor ($5 in chips)
Seat 4: hullujussi85 ($8.86 in chips)
Seat 5: growingfish1 ($9.46 in chips)
Seat 6: Luettefee ($4.24 in chips)
a91891981: posts small blind $0.02
Baksojor: posts big blind $0.05
*** HOLE CARDS ***
Dealt to Baksojor [5h Qs]
hullujussi85: raises $0.07 to $0.12
growingfish1: folds
Luettefee: folds
1000G's: calls $0.12
a91891981: folds
Baksojor: folds
*** FLOP *** [3s 8d Jc]
hullujussi85: bets $0.15
1000G's: calls $0.15
*** TURN *** [3s 8d Jc] [Kc]
hullujussi85: checks
1000G's: checks
*** RIVER *** [3s 8d Jc Kc] [8c]
hullujussi85: checks
1000G's: bets $0.40
hullujussi85: folds
Uncalled bet ($0.40) returned to 1000G's
1000G's collected $0.58 from pot
1000G's: doesn't show hand
*** SUMMARY ***
Total pot $0.61 | Rake $0.03
Board [3s 8d Jc Kc 8c]
Seat 1: 1000G's (button) collected ($0.58)
Seat 2: a91891981 (small blind) folded before Flop
Seat 3: Baksojor (big blind) folded before Flop
Seat 4: hullujussi85 folded on the River
Seat 5: growingfish1 folded before Flop (didn't bet)
Seat 6: Luettefee folded before Flop (didn't bet)


*********** # 125 **************
PokerStars Zoom Hand #174065291163:  Hold'em No Limit ($0.02/$0.05) - 2017/08/08 10:38:36 MSK [2017/08/08 3:38:36 ET]
Table 'Donati' 6-max Seat #1 is the button
Seat 1: oceanmanvvv ($8.22 in chips)
Seat 2: SynWiz ($5 in chips)
Seat 3: matos chuim ($2.61 in chips)
Seat 4: NxtSvd ($5.31 in chips)
Seat 5: Baksojor ($5 in chips)
Seat 6: anorectal ($5.81 in chips)
SynWiz: posts small blind $0.02
matos chuim: posts big blind $0.05
*** HOLE CARDS ***
Dealt to Baksojor [Kh 8c]
NxtSvd: calls $0.05
Baksojor: folds
anorectal: folds
oceanmanvvv: folds
SynWiz: folds
matos chuim: checks
*** FLOP *** [6s 9h Tc]
matos chuim: checks
NxtSvd: bets $0.05
matos chuim: folds
Uncalled bet ($0.05) returned to NxtSvd
NxtSvd collected $0.12 from pot
NxtSvd: doesn't show hand
*** SUMMARY ***
Total pot $0.12 | Rake $0
Board [6s 9h Tc]
Seat 1: oceanmanvvv (button) folded before Flop (didn't bet)
Seat 2: SynWiz (small blind) folded before Flop
Seat 3: matos chuim (big blind) folded on the Flop
Seat 4: NxtSvd collected ($0.12)
Seat 5: Baksojor folded before Flop (didn't bet)
Seat 6: anorectal folded before Flop (didn't bet)


*********** # 126 **************
PokerStars Zoom Hand #174065277440:  Hold'em No Limit ($0.02/$0.05) - 2017/08/08 10:37:43 MSK [2017/08/08 3:37:43 ET]
Table 'Donati' 6-max Seat #1 is the button
Seat 1: Baksojor ($5.51 in chips)
Seat 2: kita8444 ($9.42 in chips)
Seat 3: 3iourou ($5 in chips)
Seat 4: Nino0208 ($2.54 in chips)
Seat 5: V.S.151 ($7.09 in chips)
Seat 6: Sita1986 ($6.15 in chips)
kita8444: posts small blind $0.02
3iourou: posts big blind $0.05
*** HOLE CARDS ***
Dealt to Baksojor [9c Jc]
Nino0208: folds
V.S.151: folds
Sita1986: folds
Baksojor: raises $0.05 to $0.10
kita8444: calls $0.08
3iourou: raises $0.20 to $0.30
Baksojor: calls $0.20
kita8444: folds
*** FLOP *** [9s 2h 4c]
3iourou: bets $0.95
Baksojor: calls $0.95
*** TURN *** [9s 2h 4c] [5d]
3iourou: bets $3.54
Baksojor: raises $0.72 to $4.26 and is all-in
3iourou: calls $0.21 and is all-in
Uncalled bet ($0.51) returned to Baksojor
*** FIRST RIVER *** [9s 2h 4c 5d] [Qh]
*** SECOND RIVER *** [9s 2h 4c 5d] [Kh]
*** FIRST SHOW DOWN ***
3iourou: shows [9d 4d] (two pair, Nines and Fours)
Baksojor: shows [9c Jc] (a pair of Nines)
3iourou collected $4.84 from pot
*** SECOND SHOW DOWN ***
3iourou: shows [9d 4d] (two pair, Nines and Fours)
Baksojor: shows [9c Jc] (a pair of Nines)
3iourou collected $4.84 from pot
*** SUMMARY ***
Total pot $10.10 | Rake $0.42
Hand was run twice
FIRST Board [9s 2h 4c 5d Qh]
SECOND Board [9s 2h 4c 5d Kh]
Seat 1: Baksojor (button) showed [9c Jc] and lost with a pair of Nines, and lost with a pair of Nines
Seat 2: kita8444 (small blind) folded before Flop
Seat 3: 3iourou (big blind) showed [9d 4d] and won ($4.84) with two pair, Nines and Fours, and won ($4.84) with two pair, Nines and Fours
Seat 4: Nino0208 folded before Flop (didn't bet)
Seat 5: V.S.151 folded before Flop (didn't bet)
Seat 6: Sita1986 folded before Flop (didn't bet)


*********** # 127 **************
PokerStars Zoom Hand #174065268472:  Hold'em No Limit ($0.02/$0.05) - 2017/08/08 10:37:08 MSK [2017/08/08 3:37:08 ET]
Table 'Donati' 6-max Seat #1 is the button
Seat 1: Astour194 ($5 in chips)
Seat 2: IGROK101 ($5.24 in chips)
Seat 3: Baksojor ($5.35 in chips)
Seat 4: JBatistaO ($5.16 in chips)
Seat 5: ilsol ($10.72 in chips)
Seat 6: 1000G's ($9.35 in chips)
IGROK101: posts small blind $0.02
Baksojor: posts big blind $0.05
*** HOLE CARDS ***
Dealt to Baksojor [9h 9c]
JBatistaO: folds
ilsol: raises $0.10 to $0.15
1000G's: folds
Astour194: folds
IGROK101: folds
Baksojor: calls $0.10
*** FLOP *** [Th 2c 4s]
Baksojor: checks
ilsol: checks
*** TURN *** [Th 2c 4s] [5d]
Baksojor: bets $0.20
ilsol: folds
Uncalled bet ($0.20) returned to Baksojor
Baksojor collected $0.31 from pot
Baksojor: doesn't show hand
*** SUMMARY ***
Total pot $0.32 | Rake $0.01
Board [Th 2c 4s 5d]
Seat 1: Astour194 (button) folded before Flop (didn't bet)
Seat 2: IGROK101 (small blind) folded before Flop
Seat 3: Baksojor (big blind) collected ($0.31)
Seat 4: JBatistaO folded before Flop (didn't bet)
Seat 5: ilsol folded on the Turn
Seat 6: 1000G's folded before Flop (didn't bet)


*********** # 128 **************
PokerStars Zoom Hand #174065252532:  Hold'em No Limit ($0.02/$0.05) - 2017/08/08 10:36:07 MSK [2017/08/08 3:36:07 ET]
Table 'Donati' 6-max Seat #1 is the button
Seat 1: IDontLoveGod ($7.12 in chips)
Seat 2: simple s0o ($5.74 in chips)
Seat 3: Zapr0100 ($5 in chips)
Seat 4: Punzzzer ($5.62 in chips)
Seat 5: oceanmanvvv ($8.22 in chips)
Seat 6: Baksojor ($5.28 in chips)
simple s0o: posts small blind $0.02
Zapr0100: posts big blind $0.05
*** HOLE CARDS ***
Dealt to Baksojor [Qh Jd]
Punzzzer: folds
oceanmanvvv: folds
Baksojor: raises $0.07 to $0.12
IDontLoveGod: folds
simple s0o: folds
Zapr0100 has timed out
Zapr0100: folds
Uncalled bet ($0.07) returned to Baksojor
Baksojor collected $0.12 from pot
Baksojor: doesn't show hand
*** SUMMARY ***
Total pot $0.12 | Rake $0
Seat 1: IDontLoveGod (button) folded before Flop (didn't bet)
Seat 2: simple s0o (small blind) folded before Flop
Seat 3: Zapr0100 (big blind) folded before Flop
Seat 4: Punzzzer folded before Flop (didn't bet)
Seat 5: oceanmanvvv folded before Flop (didn't bet)
Seat 6: Baksojor collected ($0.12)


*********** # 129 **************
PokerStars Zoom Hand #174065251236:  Hold'em No Limit ($0.02/$0.05) - 2017/08/08 10:36:02 MSK [2017/08/08 3:36:02 ET]
Table 'Donati' 6-max Seat #1 is the button
Seat 1: azndude8 ($6.82 in chips)
Seat 2: Peauker123 ($7.12 in chips)
Seat 3: svenev ($7.01 in chips)
Seat 4: Baksojor ($5.28 in chips)
Seat 5: hesperus132 ($5.74 in chips)
Seat 6: hiebsch87 ($6.15 in chips)
Peauker123: posts small blind $0.02
svenev: posts big blind $0.05
*** HOLE CARDS ***
Dealt to Baksojor [Qh 8h]
Baksojor: folds
hesperus132: folds
hiebsch87: raises $0.07 to $0.12
azndude8: folds
Peauker123: raises $0.23 to $0.35
svenev: folds
hiebsch87: folds
Uncalled bet ($0.23) returned to Peauker123
Peauker123 collected $0.29 from pot
Peauker123: doesn't show hand
*** SUMMARY ***
Total pot $0.29 | Rake $0
Seat 1: azndude8 (button) folded before Flop (didn't bet)
Seat 2: Peauker123 (small blind) collected ($0.29)
Seat 3: svenev (big blind) folded before Flop
Seat 4: Baksojor folded before Flop (didn't bet)
Seat 5: hesperus132 folded before Flop (didn't bet)
Seat 6: hiebsch87 folded before Flop


*********** # 130 **************
PokerStars Zoom Hand #174065250147:  Hold'em No Limit ($0.02/$0.05) - 2017/08/08 10:35:58 MSK [2017/08/08 3:35:58 ET]
Table 'Donati' 6-max Seat #1 is the button
Seat 1: antonis1988 ($24.50 in chips)
Seat 2: anorectal ($5.75 in chips)
Seat 3: tescaw ($5.57 in chips)
Seat 4: TaskuJJ ($17.26 in chips)
Seat 5: Punzzzer ($5.62 in chips)
Seat 6: Baksojor ($5.28 in chips)
anorectal: posts small blind $0.02
tescaw: posts big blind $0.05
*** HOLE CARDS ***
Dealt to Baksojor [4s Jh]
TaskuJJ: folds
Punzzzer: folds
Baksojor: folds
antonis1988: raises $0.07 to $0.12
anorectal: folds
tescaw: calls $0.07
*** FLOP *** [Qh Ad 4c]
tescaw: checks
antonis1988: bets $0.14
tescaw: calls $0.14
*** TURN *** [Qh Ad 4c] [5h]
tescaw: checks
antonis1988: checks
*** RIVER *** [Qh Ad 4c 5h] [6s]
tescaw: checks
antonis1988: checks
*** SHOW DOWN ***
tescaw: shows [Qc 9s] (a pair of Queens)
antonis1988: shows [Tc Qd] (a pair of Queens - Ace+Ten kicker)
antonis1988 collected $0.52 from pot
*** SUMMARY ***
Total pot $0.54 | Rake $0.02
Board [Qh Ad 4c 5h 6s]
Seat 1: antonis1988 (button) showed [Tc Qd] and won ($0.52) with a pair of Queens
Seat 2: anorectal (small blind) folded before Flop
Seat 3: tescaw (big blind) showed [Qc 9s] and lost with a pair of Queens
Seat 4: TaskuJJ folded before Flop (didn't bet)
Seat 5: Punzzzer folded before Flop (didn't bet)
Seat 6: Baksojor folded before Flop (didn't bet)


*********** # 131 **************
PokerStars Zoom Hand #174065249110:  Hold'em No Limit ($0.02/$0.05) - 2017/08/08 10:35:54 MSK [2017/08/08 3:35:54 ET]
Table 'Donati' 6-max Seat #1 is the button
Seat 1: IGOR1957 ($7.84 in chips)
Seat 2: Eremka89 ($3 in chips)
Seat 3: MutbKa01 ($5.42 in chips)
Seat 4: SquirtleSquad ($5.07 in chips)
Seat 5: Baksojor ($5.28 in chips)
Seat 6: 1000G's ($4.94 in chips)
Eremka89: posts small blind $0.02
MutbKa01: posts big blind $0.05
*** HOLE CARDS ***
Dealt to Baksojor [6d 8s]
SquirtleSquad: raises $0.10 to $0.15
Baksojor: folds
1000G's: folds
IGOR1957: folds
Eremka89: calls $0.13
MutbKa01: folds
*** FLOP *** [2h 7d 8h]
Eremka89: checks
SquirtleSquad: bets $0.20
Eremka89: calls $0.20
*** TURN *** [2h 7d 8h] [4s]
Eremka89: checks
SquirtleSquad: checks
*** RIVER *** [2h 7d 8h 4s] [6h]
Eremka89: checks
SquirtleSquad: checks
*** SHOW DOWN ***
Eremka89: shows [Th Kh] (a flush, King high)
SquirtleSquad: mucks hand
Eremka89 collected $0.72 from pot
*** SUMMARY ***
Total pot $0.75 | Rake $0.03
Board [2h 7d 8h 4s 6h]
Seat 1: IGOR1957 (button) folded before Flop (didn't bet)
Seat 2: Eremka89 (small blind) showed [Th Kh] and won ($0.72) with a flush, King high
Seat 3: MutbKa01 (big blind) folded before Flop
Seat 4: SquirtleSquad mucked [Js Qs]
Seat 5: Baksojor folded before Flop (didn't bet)
Seat 6: 1000G's folded before Flop (didn't bet)


*********** # 132 **************
PokerStars Zoom Hand #174065242980:  Hold'em No Limit ($0.02/$0.05) - 2017/08/08 10:35:30 MSK [2017/08/08 3:35:30 ET]
Table 'Donati' 6-max Seat #1 is the button
Seat 1: swesda21 ($5 in chips)
Seat 2: Baksojor ($5.11 in chips)
Seat 3: Suiccidal ($0.44 in chips)
Seat 4: SquirtleSquad ($5.43 in chips)
Seat 5: j18010030 ($8.65 in chips)
Seat 6: antonis1988 ($24.48 in chips)
Baksojor: posts small blind $0.02
Suiccidal: posts big blind $0.05
*** HOLE CARDS ***
Dealt to Baksojor [7d Td]
SquirtleSquad: folds
j18010030: folds
antonis1988: folds
swesda21: raises $0.07 to $0.12
Baksojor: raises $0.33 to $0.45
Suiccidal: folds
swesda21: folds
Uncalled bet ($0.33) returned to Baksojor
Baksojor collected $0.29 from pot
Baksojor: doesn't show hand
*** SUMMARY ***
Total pot $0.29 | Rake $0
Seat 1: swesda21 (button) folded before Flop
Seat 2: Baksojor (small blind) collected ($0.29)
Seat 3: Suiccidal (big blind) folded before Flop
Seat 4: SquirtleSquad folded before Flop (didn't bet)
Seat 5: j18010030 folded before Flop (didn't bet)
Seat 6: antonis1988 folded before Flop (didn't bet)


*********** # 133 **************
PokerStars Zoom Hand #174065238859:  Hold'em No Limit ($0.02/$0.05) - 2017/08/08 10:35:14 MSK [2017/08/08 3:35:14 ET]
Table 'Donati' 6-max Seat #1 is the button
Seat 1: Baksojor ($5.11 in chips)
Seat 2: JBatistaO ($6.73 in chips)
Seat 3: 999kknd777 ($4.72 in chips)
Seat 4: TeddyTaiwan ($5.47 in chips)
Seat 5: Dasha_1989 ($5.26 in chips)
Seat 6: growingfish1 ($11.93 in chips)
JBatistaO: posts small blind $0.02
999kknd777: posts big blind $0.05
*** HOLE CARDS ***
Dealt to Baksojor [9s Tc]
TeddyTaiwan: raises $0.10 to $0.15
Dasha_1989: folds
growingfish1: folds
Baksojor: folds
JBatistaO: folds
999kknd777: folds
Uncalled bet ($0.10) returned to TeddyTaiwan
TeddyTaiwan collected $0.12 from pot
TeddyTaiwan: doesn't show hand
*** SUMMARY ***
Total pot $0.12 | Rake $0
Seat 1: Baksojor (button) folded before Flop (didn't bet)
Seat 2: JBatistaO (small blind) folded before Flop
Seat 3: 999kknd777 (big blind) folded before Flop
Seat 4: TeddyTaiwan collected ($0.12)
Seat 5: Dasha_1989 folded before Flop (didn't bet)
Seat 6: growingfish1 folded before Flop (didn't bet)


*********** # 134 **************
PokerStars Zoom Hand #174065234982:  Hold'em No Limit ($0.02/$0.05) - 2017/08/08 10:34:59 MSK [2017/08/08 3:34:59 ET]
Table 'Donati' 6-max Seat #1 is the button
Seat 1: MardarYD ($5.43 in chips)
Seat 2: Sabarakk ($5.80 in chips)
Seat 3: Baksojor ($5.16 in chips)
Seat 4: Vlad-Kalash ($3.85 in chips)
Seat 5: Stt1000 ($2.73 in chips)
Seat 6: Miracle1357 ($6.10 in chips)
Sabarakk: posts small blind $0.02
Baksojor: posts big blind $0.05
*** HOLE CARDS ***
Dealt to Baksojor [5d 2h]
Vlad-Kalash: raises $0.12 to $0.17
Stt1000: folds
Miracle1357: folds
MardarYD: folds
Sabarakk: folds
Baksojor: folds
Uncalled bet ($0.12) returned to Vlad-Kalash
Vlad-Kalash collected $0.12 from pot
Vlad-Kalash: doesn't show hand
*** SUMMARY ***
Total pot $0.12 | Rake $0
Seat 1: MardarYD (button) folded before Flop (didn't bet)
Seat 2: Sabarakk (small blind) folded before Flop
Seat 3: Baksojor (big blind) folded before Flop
Seat 4: Vlad-Kalash collected ($0.12)
Seat 5: Stt1000 folded before Flop (didn't bet)
Seat 6: Miracle1357 folded before Flop (didn't bet)


*********** # 135 **************
PokerStars Zoom Hand #174065233985:  Hold'em No Limit ($0.02/$0.05) - 2017/08/08 10:34:55 MSK [2017/08/08 3:34:55 ET]
Table 'Donati' 6-max Seat #1 is the button
Seat 1: Tom_Jerry373 ($2.11 in chips)
Seat 2: Baksojor ($5.18 in chips)
Seat 3: Evetrin ($5.20 in chips)
Seat 4: mnorde ($6.56 in chips)
Seat 5: 01R#tS ($5 in chips)
Seat 6: rdavek ($7.33 in chips)
Baksojor: posts small blind $0.02
Evetrin: posts big blind $0.05
*** HOLE CARDS ***
Dealt to Baksojor [6h Qc]
mnorde: folds
01R#tS: folds
rdavek: folds
Tom_Jerry373: folds
Baksojor: folds
Uncalled bet ($0.03) returned to Evetrin
Evetrin collected $0.04 from pot
Evetrin: doesn't show hand
*** SUMMARY ***
Total pot $0.04 | Rake $0
Seat 1: Tom_Jerry373 (button) folded before Flop (didn't bet)
Seat 2: Baksojor (small blind) folded before Flop
Seat 3: Evetrin (big blind) collected ($0.04)
Seat 4: mnorde folded before Flop (didn't bet)
Seat 5: 01R#tS folded before Flop (didn't bet)
Seat 6: rdavek folded before Flop (didn't bet)


*********** # 136 **************
PokerStars Zoom Hand #174065232909:  Hold'em No Limit ($0.02/$0.05) - 2017/08/08 10:34:51 MSK [2017/08/08 3:34:51 ET]
Table 'Donati' 6-max Seat #1 is the button
Seat 1: ilsol ($10.98 in chips)
Seat 2: gela111 ($1.92 in chips)
Seat 3: JBatistaO ($5.47 in chips)
Seat 4: Baksojor ($5.18 in chips)
Seat 5: Dasha_1989 ($5.16 in chips)
Seat 6: merfol ($3.65 in chips)
gela111: posts small blind $0.02
JBatistaO: posts big blind $0.05
*** HOLE CARDS ***
Dealt to Baksojor [Td 3h]
Baksojor: folds
Dasha_1989: folds
merfol: folds
ilsol: folds
gela111: raises $0.05 to $0.10
JBatistaO: calls $0.05
*** FLOP *** [9h 5h 6h]
gela111: checks
JBatistaO: checks
*** TURN *** [9h 5h 6h] [9d]
gela111: bets $0.05
JBatistaO: calls $0.05
*** RIVER *** [9h 5h 6h 9d] [5d]
gela111: checks
JBatistaO: checks
*** SHOW DOWN ***
gela111: shows [Kd Qc] (two pair, Nines and Fives)
JBatistaO: mucks hand
gela111 collected $0.29 from pot
*** SUMMARY ***
Total pot $0.30 | Rake $0.01
Board [9h 5h 6h 9d 5d]
Seat 1: ilsol (button) folded before Flop (didn't bet)
Seat 2: gela111 (small blind) showed [Kd Qc] and won ($0.29) with two pair, Nines and Fives
Seat 3: JBatistaO (big blind) mucked [3c 3s]
Seat 4: Baksojor folded before Flop (didn't bet)
Seat 5: Dasha_1989 folded before Flop (didn't bet)
Seat 6: merfol folded before Flop (didn't bet)


*********** # 137 **************
PokerStars Zoom Hand #174065231893:  Hold'em No Limit ($0.02/$0.05) - 2017/08/08 10:34:47 MSK [2017/08/08 3:34:47 ET]
Table 'Donati' 6-max Seat #1 is the button
Seat 1: 3iourou ($5 in chips)
Seat 2: judy2222 ($12.20 in chips)
Seat 3: simple s0o ($13.21 in chips)
Seat 4: pipecmolodec ($5.63 in chips)
Seat 5: Baksojor ($5.18 in chips)
Seat 6: svenev ($5.31 in chips)
judy2222: posts small blind $0.02
simple s0o: posts big blind $0.05
*** HOLE CARDS ***
Dealt to Baksojor [8h 6d]
pipecmolodec: folds
Baksojor: folds
svenev: folds
3iourou: folds
judy2222: folds
Uncalled bet ($0.03) returned to simple s0o
simple s0o collected $0.04 from pot
simple s0o: doesn't show hand
*** SUMMARY ***
Total pot $0.04 | Rake $0
Seat 1: 3iourou (button) folded before Flop (didn't bet)
Seat 2: judy2222 (small blind) folded before Flop
Seat 3: simple s0o (big blind) collected ($0.04)
Seat 4: pipecmolodec folded before Flop (didn't bet)
Seat 5: Baksojor folded before Flop (didn't bet)
Seat 6: svenev folded before Flop (didn't bet)


*********** # 138 **************
PokerStars Zoom Hand #174065230603:  Hold'em No Limit ($0.02/$0.05) - 2017/08/08 10:34:42 MSK [2017/08/08 3:34:42 ET]
Table 'Donati' 6-max Seat #1 is the button
Seat 1: Astour194 ($5 in chips)
Seat 2: umair01982 ($4.73 in chips)
Seat 3: pehtaras22 ($5 in chips)
Seat 4: mnorde ($6.56 in chips)
Seat 5: 01R#tS ($6.96 in chips)
Seat 6: Baksojor ($5.18 in chips)
umair01982: posts small blind $0.02
pehtaras22: posts big blind $0.05
*** HOLE CARDS ***
Dealt to Baksojor [7s Qc]
mnorde: folds
01R#tS: folds
Baksojor: folds
Astour194: raises $0.08 to $0.13
umair01982: folds
pehtaras22: folds
Uncalled bet ($0.08) returned to Astour194
Astour194 collected $0.12 from pot
Astour194: doesn't show hand
*** SUMMARY ***
Total pot $0.12 | Rake $0
Seat 1: Astour194 (button) collected ($0.12)
Seat 2: umair01982 (small blind) folded before Flop
Seat 3: pehtaras22 (big blind) folded before Flop
Seat 4: mnorde folded before Flop (didn't bet)
Seat 5: 01R#tS folded before Flop (didn't bet)
Seat 6: Baksojor folded before Flop (didn't bet)


*********** # 139 **************
PokerStars Zoom Hand #174065217574:  Hold'em No Limit ($0.02/$0.05) - 2017/08/08 10:33:51 MSK [2017/08/08 3:33:51 ET]
Table 'Donati' 6-max Seat #1 is the button
Seat 1: Baksojor ($5 in chips)
Seat 2: azndude8 ($6.22 in chips)
Seat 3: freekidwei ($5.20 in chips)
Seat 4: Culiacan448 ($4.57 in chips)
Seat 5: umair01982 ($4.71 in chips)
Seat 6: CardinalA282 ($6.22 in chips)
azndude8: posts small blind $0.02
freekidwei: posts big blind $0.05
*** HOLE CARDS ***
Dealt to Baksojor [8d 8s]
Culiacan448: raises $0.07 to $0.12
umair01982: folds
CardinalA282: folds
Baksojor: calls $0.12
azndude8: folds
freekidwei: folds
*** FLOP *** [Jd Qc Ad]
Culiacan448: checks
Baksojor: checks
*** TURN *** [Jd Qc Ad] [5h]
Culiacan448: checks
Baksojor: checks
*** RIVER *** [Jd Qc Ad 5h] [Ac]
Culiacan448: checks
Baksojor: checks
*** SHOW DOWN ***
Culiacan448: shows [6d 5d] (two pair, Aces and Fives)
Baksojor: shows [8d 8s] (two pair, Aces and Eights)
Baksojor collected $0.30 from pot
*** SUMMARY ***
Total pot $0.31 | Rake $0.01
Board [Jd Qc Ad 5h Ac]
Seat 1: Baksojor (button) showed [8d 8s] and won ($0.30) with two pair, Aces and Eights
Seat 2: azndude8 (small blind) folded before Flop
Seat 3: freekidwei (big blind) folded before Flop
Seat 4: Culiacan448 showed [6d 5d] and lost with two pair, Aces and Fives
Seat 5: umair01982 folded before Flop (didn't bet)
Seat 6: CardinalA282 folded before Flop (didn't bet)


*********** # 140 **************
PokerStars Zoom Hand #174065215822:  Hold'em No Limit ($0.02/$0.05) - 2017/08/08 10:33:44 MSK [2017/08/08 3:33:44 ET]
Table 'Donati' 6-max Seat #1 is the button
Seat 1: funtik00001 ($4.74 in chips)
Seat 2: Baksojor ($5.02 in chips)
Seat 3: Artem1Z ($7.27 in chips)
Seat 4: AVLeo_arh ($5.53 in chips)
Seat 5: fidelmp ($4.93 in chips)
Seat 6: lilyknight ($6.21 in chips)
Baksojor: posts small blind $0.02
Artem1Z: posts big blind $0.05
*** HOLE CARDS ***
Dealt to Baksojor [6d Jh]
AVLeo_arh: folds
fidelmp: calls $0.05
lilyknight: folds
funtik00001: folds
Baksojor: folds
Artem1Z: raises $0.10 to $0.15
fidelmp: calls $0.10
*** FLOP *** [9d As Ah]
Artem1Z: checks
fidelmp: bets $0.05
Artem1Z: calls $0.05
*** TURN *** [9d As Ah] [6c]
Artem1Z: checks
fidelmp: checks
*** RIVER *** [9d As Ah 6c] [2h]
Artem1Z: bets $0.35
fidelmp: folds
Uncalled bet ($0.35) returned to Artem1Z
Artem1Z collected $0.40 from pot
Artem1Z: doesn't show hand
*** SUMMARY ***
Total pot $0.42 | Rake $0.02
Board [9d As Ah 6c 2h]
Seat 1: funtik00001 (button) folded before Flop (didn't bet)
Seat 2: Baksojor (small blind) folded before Flop
Seat 3: Artem1Z (big blind) collected ($0.40)
Seat 4: AVLeo_arh folded before Flop (didn't bet)
Seat 5: fidelmp folded on the River
Seat 6: lilyknight folded before Flop (didn't bet)


*********** # 141 **************
PokerStars Zoom Hand #174065213985:  Hold'em No Limit ($0.02/$0.05) - 2017/08/08 10:33:37 MSK [2017/08/08 3:33:37 ET]
Table 'Donati' 6-max Seat #1 is the button
Seat 1: AndewRobin ($6.73 in chips)
Seat 2: anorectal ($5.82 in chips)
Seat 3: Baksojor ($5 in chips)
Seat 4: swesda21 ($5.12 in chips)
Seat 5: 1000G's ($4.83 in chips)
Seat 6: 070920 ($3.57 in chips)
anorectal: posts small blind $0.02
Baksojor: posts big blind $0.05
*** HOLE CARDS ***
Dealt to Baksojor [6c 7s]
swesda21: folds
1000G's: folds
070920: folds
AndewRobin: folds
anorectal: folds
Uncalled bet ($0.03) returned to Baksojor
Baksojor collected $0.04 from pot
Baksojor: doesn't show hand
*** SUMMARY ***
Total pot $0.04 | Rake $0
Seat 1: AndewRobin (button) folded before Flop (didn't bet)
Seat 2: anorectal (small blind) folded before Flop
Seat 3: Baksojor (big blind) collected ($0.04)
Seat 4: swesda21 folded before Flop (didn't bet)
Seat 5: 1000G's folded before Flop (didn't bet)
Seat 6: 070920 folded before Flop (didn't bet)


*********** # 142 **************
PokerStars Zoom Hand #174049627323:  Hold'em No Limit ($0.02/$0.05) - 2017/08/07 23:59:46 MSK [2017/08/07 16:59:46 ET]
Table 'Donati' 6-max Seat #1 is the button
Seat 1: B0GEYMAN ($8.09 in chips)
Seat 2: Majkee88 ($21.52 in chips)
Seat 3: Anton Tr ($5.88 in chips)
Seat 4: lucky_gabbi ($2.88 in chips)
Seat 5: validosha ($2.58 in chips)
Seat 6: Baksojor ($5.95 in chips)
Majkee88: posts small blind $0.02
Anton Tr: posts big blind $0.05
*** HOLE CARDS ***
Dealt to Baksojor [5s 6h]
lucky_gabbi: raises $0.10 to $0.15
validosha: folds
Baksojor: folds
B0GEYMAN: folds
Majkee88: folds
Anton Tr: folds
Uncalled bet ($0.10) returned to lucky_gabbi
lucky_gabbi collected $0.12 from pot
lucky_gabbi: doesn't show hand
*** SUMMARY ***
Total pot $0.12 | Rake $0
Seat 1: B0GEYMAN (button) folded before Flop (didn't bet)
Seat 2: Majkee88 (small blind) folded before Flop
Seat 3: Anton Tr (big blind) folded before Flop
Seat 4: lucky_gabbi collected ($0.12)
Seat 5: validosha folded before Flop (didn't bet)
Seat 6: Baksojor folded before Flop (didn't bet)


*********** # 143 **************
PokerStars Zoom Hand #174049616056:  Hold'em No Limit ($0.02/$0.05) - 2017/08/07 23:59:28 MSK [2017/08/07 16:59:28 ET]
Table 'Donati' 6-max Seat #1 is the button
Seat 1: Baksojor ($5.95 in chips)
Seat 2: hen1337 ($8.92 in chips)
Seat 3: mmegan92 ($11.89 in chips)
Seat 4: Girigal ($5.70 in chips)
Seat 5: chraeder ($3.80 in chips)
Seat 6: Pahuljica37 ($5.46 in chips)
hen1337: posts small blind $0.02
mmegan92: posts big blind $0.05
*** HOLE CARDS ***
Dealt to Baksojor [Ts 8d]
Girigal: folds
chraeder: raises $0.07 to $0.12
Pahuljica37: folds
Baksojor: folds
hen1337: folds
mmegan92: folds
Uncalled bet ($0.07) returned to chraeder
chraeder collected $0.12 from pot
chraeder: doesn't show hand
*** SUMMARY ***
Total pot $0.12 | Rake $0
Seat 1: Baksojor (button) folded before Flop (didn't bet)
Seat 2: hen1337 (small blind) folded before Flop
Seat 3: mmegan92 (big blind) folded before Flop
Seat 4: Girigal folded before Flop (didn't bet)
Seat 5: chraeder collected ($0.12)
Seat 6: Pahuljica37 folded before Flop (didn't bet)


*********** # 144 **************
PokerStars Zoom Hand #174049574653:  Hold'em No Limit ($0.02/$0.05) - 2017/08/07 23:58:23 MSK [2017/08/07 16:58:23 ET]
Table 'Donati' 6-max Seat #1 is the button
Seat 1: IldarD86 ($7.73 in chips)
Seat 2: Taron-gao ($6.30 in chips)
Seat 3: 777serg58 ($6.43 in chips)
Seat 4: Baksojor ($12.25 in chips)
Seat 5: Sviat47 ($6.53 in chips)
Seat 6: Levmachinexx ($11.46 in chips)
Taron-gao: posts small blind $0.02
777serg58: posts big blind $0.05
*** HOLE CARDS ***
Dealt to Baksojor [Kc Ks]
Baksojor: raises $0.10 to $0.15
Sviat47: folds
Levmachinexx: folds
IldarD86: folds
Taron-gao: calls $0.13
777serg58: folds
*** FLOP *** [6h 5c Qc]
Taron-gao: bets $0.20
Baksojor: raises $0.45 to $0.65
Taron-gao: raises $0.95 to $1.60
Baksojor: calls $0.95
*** TURN *** [6h 5c Qc] [7d]
Taron-gao: bets $4.55 and is all-in
Baksojor: calls $4.55
*** RIVER *** [6h 5c Qc 7d] [4c]
*** SHOW DOWN ***
Taron-gao: shows [8h 9h] (a straight, Five to Nine)
Baksojor: shows [Kc Ks] (a pair of Kings)
Taron-gao collected $12.13 from pot
*** SUMMARY ***
Total pot $12.65 | Rake $0.52
Board [6h 5c Qc 7d 4c]
Seat 1: IldarD86 (button) folded before Flop (didn't bet)
Seat 2: Taron-gao (small blind) showed [8h 9h] and won ($12.13) with a straight, Five to Nine
Seat 3: 777serg58 (big blind) folded before Flop
Seat 4: Baksojor showed [Kc Ks] and lost with a pair of Kings
Seat 5: Sviat47 folded before Flop (didn't bet)
Seat 6: Levmachinexx folded before Flop (didn't bet)


*********** # 145 **************
PokerStars Zoom Hand #174049565191:  Hold'em No Limit ($0.02/$0.05) - 2017/08/07 23:58:08 MSK [2017/08/07 16:58:08 ET]
Table 'Donati' 6-max Seat #1 is the button
Seat 1: Naosky ($6.25 in chips)
Seat 2: InteRus13 ($4.88 in chips)
Seat 3: Baksojor ($12.23 in chips)
Seat 4: legitspade12 ($11.02 in chips)
Seat 5: Sabarakk ($6.02 in chips)
Seat 6: eduardogod ($6.28 in chips)
InteRus13: posts small blind $0.02
Baksojor: posts big blind $0.05
*** HOLE CARDS ***
Dealt to Baksojor [Ts Ks]
legitspade12: folds
Sabarakk: folds
eduardogod: folds
Naosky: folds
InteRus13: folds
Uncalled bet ($0.03) returned to Baksojor
Baksojor collected $0.04 from pot
Baksojor: doesn't show hand
*** SUMMARY ***
Total pot $0.04 | Rake $0
Seat 1: Naosky (button) folded before Flop (didn't bet)
Seat 2: InteRus13 (small blind) folded before Flop
Seat 3: Baksojor (big blind) collected ($0.04)
Seat 4: legitspade12 folded before Flop (didn't bet)
Seat 5: Sabarakk folded before Flop (didn't bet)
Seat 6: eduardogod folded before Flop (didn't bet)


*********** # 146 **************
PokerStars Zoom Hand #174049561423:  Hold'em No Limit ($0.02/$0.05) - 2017/08/07 23:58:02 MSK [2017/08/07 16:58:02 ET]
Table 'Donati' 6-max Seat #1 is the button
Seat 1: duniy ($12.32 in chips)
Seat 2: Baksojor ($12.25 in chips)
Seat 3: Sviat47 ($6.38 in chips)
Seat 4: Lina6591 ($2.48 in chips)
Seat 5: felipe_anps ($5 in chips)
Seat 6: macedow ($5.60 in chips)
Baksojor: posts small blind $0.02
Sviat47: posts big blind $0.05
*** HOLE CARDS ***
Dealt to Baksojor [7s Kh]
Lina6591: raises $0.05 to $0.10
felipe_anps: folds
macedow: folds
duniy: folds
Baksojor: folds
Sviat47: calls $0.05
*** FLOP *** [Jd 9c 4s]
Sviat47: checks
Lina6591: bets $0.11
Sviat47: raises $0.23 to $0.34
Lina6591: calls $0.23
*** TURN *** [Jd 9c 4s] [5c]
Sviat47: checks
Lina6591: bets $0.43
Sviat47: folds
Uncalled bet ($0.43) returned to Lina6591
Lina6591 collected $0.86 from pot
Lina6591: doesn't show hand
*** SUMMARY ***
Total pot $0.90 | Rake $0.04
Board [Jd 9c 4s 5c]
Seat 1: duniy (button) folded before Flop (didn't bet)
Seat 2: Baksojor (small blind) folded before Flop
Seat 3: Sviat47 (big blind) folded on the Turn
Seat 4: Lina6591 collected ($0.86)
Seat 5: felipe_anps folded before Flop (didn't bet)
Seat 6: macedow folded before Flop (didn't bet)


*********** # 147 **************
PokerStars Zoom Hand #174049550624:  Hold'em No Limit ($0.02/$0.05) - 2017/08/07 23:57:45 MSK [2017/08/07 16:57:45 ET]
Table 'Donati' 6-max Seat #1 is the button
Seat 1: Baksojor ($12.25 in chips)
Seat 2: williamnik ($12.42 in chips)
Seat 3: Sathar123 ($9.14 in chips)
Seat 4: AndreyK11 ($14.60 in chips)
Seat 5: andrej601 ($5.04 in chips)
Seat 6: IVE244 ($5.18 in chips)
williamnik: posts small blind $0.02
Sathar123: posts big blind $0.05
*** HOLE CARDS ***
Dealt to Baksojor [6d Ac]
AndreyK11: folds
andrej601: folds
IVE244: raises $0.07 to $0.12
Baksojor: folds
williamnik: folds
Sathar123: folds
Uncalled bet ($0.07) returned to IVE244
IVE244 collected $0.12 from pot
IVE244: doesn't show hand
*** SUMMARY ***
Total pot $0.12 | Rake $0
Seat 1: Baksojor (button) folded before Flop (didn't bet)
Seat 2: williamnik (small blind) folded before Flop
Seat 3: Sathar123 (big blind) folded before Flop
Seat 4: AndreyK11 folded before Flop (didn't bet)
Seat 5: andrej601 folded before Flop (didn't bet)
Seat 6: IVE244 collected ($0.12)


*********** # 148 **************
PokerStars Zoom Hand #174049548128:  Hold'em No Limit ($0.02/$0.05) - 2017/08/07 23:57:41 MSK [2017/08/07 16:57:41 ET]
Table 'Donati' 6-max Seat #1 is the button
Seat 1: TristanWPA ($2.57 in chips)
Seat 2: and_67rus ($4.40 in chips)
Seat 3: bajinege ($9.11 in chips)
Seat 4: donn1987 ($2.60 in chips)
Seat 5: Baksojor ($12.25 in chips)
Seat 6: qk rodriguez ($5.38 in chips)
and_67rus: posts small blind $0.02
bajinege: posts big blind $0.05
*** HOLE CARDS ***
Dealt to Baksojor [8c 5h]
donn1987: raises $0.10 to $0.15
Baksojor: folds
qk rodriguez: folds
TristanWPA: folds
and_67rus: raises $0.35 to $0.50
bajinege: folds
donn1987: calls $0.35
*** FLOP *** [Ah 3c Ac]
and_67rus: bets $0.40
donn1987: raises $0.40 to $0.80
and_67rus: folds
Uncalled bet ($0.40) returned to donn1987
donn1987 collected $1.77 from pot
donn1987: doesn't show hand
*** SUMMARY ***
Total pot $1.85 | Rake $0.08
Board [Ah 3c Ac]
Seat 1: TristanWPA (button) folded before Flop (didn't bet)
Seat 2: and_67rus (small blind) folded on the Flop
Seat 3: bajinege (big blind) folded before Flop
Seat 4: donn1987 collected ($1.77)
Seat 5: Baksojor folded before Flop (didn't bet)
Seat 6: qk rodriguez folded before Flop (didn't bet)


*********** # 149 **************
PokerStars Zoom Hand #174049544975:  Hold'em No Limit ($0.02/$0.05) - 2017/08/07 23:57:36 MSK [2017/08/07 16:57:36 ET]
Table 'Donati' 6-max Seat #1 is the button
Seat 1: MárioRJ ($7.09 in chips)
Seat 2: Dasha_1989 ($5 in chips)
Seat 3: My4Street ($8.26 in chips)
Seat 4: Baksojor ($12.25 in chips)
Seat 5: andypr0 ($17.94 in chips)
Seat 6: Fuerste2508 ($5.15 in chips)
Dasha_1989: posts small blind $0.02
My4Street: posts big blind $0.05
*** HOLE CARDS ***
Dealt to Baksojor [9s 7s]
Baksojor: folds
andypr0: folds
Fuerste2508: folds
MárioRJ: raises $0.10 to $0.15
Dasha_1989: folds
My4Street: folds
Uncalled bet ($0.10) returned to MárioRJ
MárioRJ collected $0.12 from pot
MárioRJ: doesn't show hand
*** SUMMARY ***
Total pot $0.12 | Rake $0
Seat 1: MárioRJ (button) collected ($0.12)
Seat 2: Dasha_1989 (small blind) folded before Flop
Seat 3: My4Street (big blind) folded before Flop
Seat 4: Baksojor folded before Flop (didn't bet)
Seat 5: andypr0 folded before Flop (didn't bet)
Seat 6: Fuerste2508 folded before Flop (didn't bet)


*********** # 150 **************
PokerStars Zoom Hand #174049532009:  Hold'em No Limit ($0.02/$0.05) - 2017/08/07 23:57:24 MSK [2017/08/07 16:57:24 ET]
Table 'Donati' 6-max Seat #1 is the button
Seat 1: rei785 ($2.32 in chips)
Seat 2: Demon31222 ($6.26 in chips)
Seat 3: Baksojor ($12.30 in chips)
Seat 4: mnorde ($7.16 in chips)
Seat 5: balibalzow ($5.25 in chips)
Seat 6: guilhermev85 ($5.14 in chips)
Demon31222: posts small blind $0.02
Baksojor: posts big blind $0.05
*** HOLE CARDS ***
Dealt to Baksojor [2c 5c]
mnorde: folds
balibalzow: folds
guilhermev85: raises $0.10 to $0.15
rei785: calls $0.15
Demon31222: folds
Baksojor: folds
*** FLOP *** [4h 7d 6d]
guilhermev85: checks
rei785: bets $0.20
guilhermev85: calls $0.20
*** TURN *** [4h 7d 6d] [8s]
guilhermev85: checks
rei785: checks
*** RIVER *** [4h 7d 6d 8s] [Js]
guilhermev85: checks
rei785: checks
*** SHOW DOWN ***
guilhermev85: shows [Kc Ah] (high card Ace)
rei785: shows [7c Ad] (a pair of Sevens)
rei785 collected $0.74 from pot
*** SUMMARY ***
Total pot $0.77 | Rake $0.03
Board [4h 7d 6d 8s Js]
Seat 1: rei785 (button) showed [7c Ad] and won ($0.74) with a pair of Sevens
Seat 2: Demon31222 (small blind) folded before Flop
Seat 3: Baksojor (big blind) folded before Flop
Seat 4: mnorde folded before Flop (didn't bet)
Seat 5: balibalzow folded before Flop (didn't bet)
Seat 6: guilhermev85 showed [Kc Ah] and lost with high card Ace


*********** # 151 **************
PokerStars Zoom Hand #174049522525:  Hold'em No Limit ($0.02/$0.05) - 2017/08/07 23:57:09 MSK [2017/08/07 16:57:09 ET]
Table 'Donati' 6-max Seat #1 is the button
Seat 1: Oscar__62176 ($11.18 in chips)
Seat 2: YstrAV ($33.45 in chips)
Seat 3: grant8064 ($5.20 in chips)
Seat 4: InteRus13 ($5.82 in chips)
Seat 5: Baksojor ($12.30 in chips)
Seat 6: Monsterpot13 ($4.26 in chips)
YstrAV: posts small blind $0.02
grant8064: posts big blind $0.05
*** HOLE CARDS ***
Dealt to Baksojor [Qs Jh]
InteRus13: folds
Baksojor: folds
Monsterpot13: folds
Oscar__62176: folds
YstrAV: folds
Uncalled bet ($0.03) returned to grant8064
grant8064 collected $0.04 from pot
grant8064: doesn't show hand
*** SUMMARY ***
Total pot $0.04 | Rake $0
Seat 1: Oscar__62176 (button) folded before Flop (didn't bet)
Seat 2: YstrAV (small blind) folded before Flop
Seat 3: grant8064 (big blind) collected ($0.04)
Seat 4: InteRus13 folded before Flop (didn't bet)
Seat 5: Baksojor folded before Flop (didn't bet)
Seat 6: Monsterpot13 folded before Flop (didn't bet)


*********** # 152 **************
PokerStars Zoom Hand #174049511667:  Hold'em No Limit ($0.02/$0.05) - 2017/08/07 23:56:52 MSK [2017/08/07 16:56:52 ET]
Table 'Donati' 6-max Seat #1 is the button
Seat 1: MárioRJ ($9.40 in chips)
Seat 2: delgadolisto ($8.82 in chips)
Seat 3: ElbowsKnees ($5 in chips)
Seat 4: S2M3R4Kac ($3.03 in chips)
Seat 5: freddy2704 ($4.83 in chips)
Seat 6: Baksojor ($12.23 in chips)
delgadolisto: posts small blind $0.02
ElbowsKnees: posts big blind $0.05
*** HOLE CARDS ***
Dealt to Baksojor [8h 8d]
S2M3R4Kac: folds
freddy2704: folds
Baksojor: raises $0.07 to $0.12
MárioRJ: folds
delgadolisto: folds
ElbowsKnees: folds
Uncalled bet ($0.07) returned to Baksojor
Baksojor collected $0.12 from pot
Baksojor: doesn't show hand
*** SUMMARY ***
Total pot $0.12 | Rake $0
Seat 1: MárioRJ (button) folded before Flop (didn't bet)
Seat 2: delgadolisto (small blind) folded before Flop
Seat 3: ElbowsKnees (big blind) folded before Flop
Seat 4: S2M3R4Kac folded before Flop (didn't bet)
Seat 5: freddy2704 folded before Flop (didn't bet)
Seat 6: Baksojor collected ($0.12)


*********** # 153 **************
PokerStars Zoom Hand #174049506629:  Hold'em No Limit ($0.02/$0.05) - 2017/08/07 23:56:44 MSK [2017/08/07 16:56:44 ET]
Table 'Donati' 6-max Seat #1 is the button
Seat 1: Baksojor ($12.23 in chips)
Seat 2: Ara7193 ($2.43 in chips)
Seat 3: MakeMyD@y ($6.93 in chips)
Seat 4: felipe_anps ($7.56 in chips)
Seat 5: DiBully ($4.93 in chips)
Seat 6: nacrenac1994 ($3.14 in chips)
Ara7193: posts small blind $0.02
MakeMyD@y: posts big blind $0.05
*** HOLE CARDS ***
Dealt to Baksojor [Ks 3s]
felipe_anps: folds
DiBully: raises $0.10 to $0.15
nacrenac1994: folds
Baksojor: folds
Ara7193: calls $0.13
MakeMyD@y: folds
*** FLOP *** [5d 6d Jh]
Ara7193: checks
DiBully: bets $0.17
Ara7193: raises $0.17 to $0.34
DiBully: folds
Uncalled bet ($0.17) returned to Ara7193
Ara7193 collected $0.66 from pot
Ara7193: doesn't show hand
*** SUMMARY ***
Total pot $0.69 | Rake $0.03
Board [5d 6d Jh]
Seat 1: Baksojor (button) folded before Flop (didn't bet)
Seat 2: Ara7193 (small blind) collected ($0.66)
Seat 3: MakeMyD@y (big blind) folded before Flop
Seat 4: felipe_anps folded before Flop (didn't bet)
Seat 5: DiBully folded on the Flop
Seat 6: nacrenac1994 folded before Flop (didn't bet)


*********** # 154 **************
PokerStars Zoom Hand #174049504066:  Hold'em No Limit ($0.02/$0.05) - 2017/08/07 23:56:40 MSK [2017/08/07 16:56:40 ET]
Table 'Donati' 6-max Seat #1 is the button
Seat 1: LuckyIldar ($18.43 in chips)
Seat 2: Baksojor ($12.25 in chips)
Seat 3: AndreyK11 ($5 in chips)
Seat 4: schredinger ($3.36 in chips)
Seat 5: YmanB ($4.83 in chips)
Seat 6: omgitsslave ($10.91 in chips)
Baksojor: posts small blind $0.02
AndreyK11: posts big blind $0.05
*** HOLE CARDS ***
Dealt to Baksojor [5h 8d]
schredinger: folds
YmanB: folds
omgitsslave: raises $0.09 to $0.14
LuckyIldar: folds
Baksojor: folds
AndreyK11: folds
Uncalled bet ($0.09) returned to omgitsslave
omgitsslave collected $0.12 from pot
omgitsslave: doesn't show hand
*** SUMMARY ***
Total pot $0.12 | Rake $0
Seat 1: LuckyIldar (button) folded before Flop (didn't bet)
Seat 2: Baksojor (small blind) folded before Flop
Seat 3: AndreyK11 (big blind) folded before Flop
Seat 4: schredinger folded before Flop (didn't bet)
Seat 5: YmanB folded before Flop (didn't bet)
Seat 6: omgitsslave collected ($0.12)


*********** # 155 **************
PokerStars Zoom Hand #174049482538:  Hold'em No Limit ($0.02/$0.05) - 2017/08/07 23:56:06 MSK [2017/08/07 16:56:06 ET]
Table 'Donati' 6-max Seat #1 is the button
Seat 1: jeliax ($6.63 in chips)
Seat 2: Igor22913 ($5.16 in chips)
Seat 3: Luca$$$ino ($3.03 in chips)
Seat 4: Girigal ($5 in chips)
Seat 5: romanshepp ($5.87 in chips)
Seat 6: Baksojor ($12.12 in chips)
Igor22913: posts small blind $0.02
Luca$$$ino: posts big blind $0.05
*** HOLE CARDS ***
Dealt to Baksojor [Td 9d]
Girigal: folds
romanshepp: folds
Baksojor: raises $0.07 to $0.12
jeliax: folds
Igor22913: folds
Luca$$$ino: calls $0.07
*** FLOP *** [3c As 2d]
Luca$$$ino: checks
Baksojor: bets $0.13
Luca$$$ino: folds
Uncalled bet ($0.13) returned to Baksojor
Baksojor collected $0.25 from pot
Baksojor: doesn't show hand
*** SUMMARY ***
Total pot $0.26 | Rake $0.01
Board [3c As 2d]
Seat 1: jeliax (button) folded before Flop (didn't bet)
Seat 2: Igor22913 (small blind) folded before Flop
Seat 3: Luca$$$ino (big blind) folded on the Flop
Seat 4: Girigal folded before Flop (didn't bet)
Seat 5: romanshepp folded before Flop (didn't bet)
Seat 6: Baksojor collected ($0.25)


*********** # 156 **************
PokerStars Zoom Hand #174049478004:  Hold'em No Limit ($0.02/$0.05) - 2017/08/07 23:55:59 MSK [2017/08/07 16:55:59 ET]
Table 'Donati' 6-max Seat #1 is the button
Seat 1: 999Monstr999 ($4.24 in chips)
Seat 2: smither83 ($7.72 in chips)
Seat 3: Baksojor ($12.17 in chips)
Seat 4: Bisi6611 ($9.53 in chips)
Seat 5: hellhippo ($5.81 in chips)
Seat 6: xizza ($13.82 in chips)
smither83: posts small blind $0.02
Baksojor: posts big blind $0.05
*** HOLE CARDS ***
Dealt to Baksojor [2c 8d]
Bisi6611: raises $0.10 to $0.15
hellhippo: folds
xizza: folds
999Monstr999: folds
smither83: folds
Baksojor: folds
Uncalled bet ($0.10) returned to Bisi6611
Bisi6611 collected $0.12 from pot
Bisi6611: doesn't show hand
*** SUMMARY ***
Total pot $0.12 | Rake $0
Seat 1: 999Monstr999 (button) folded before Flop (didn't bet)
Seat 2: smither83 (small blind) folded before Flop
Seat 3: Baksojor (big blind) folded before Flop
Seat 4: Bisi6611 collected ($0.12)
Seat 5: hellhippo folded before Flop (didn't bet)
Seat 6: xizza folded before Flop (didn't bet)


*********** # 157 **************
PokerStars Zoom Hand #174049473593:  Hold'em No Limit ($0.02/$0.05) - 2017/08/07 23:55:52 MSK [2017/08/07 16:55:52 ET]
Table 'Donati' 6-max Seat #1 is the button
Seat 1: C0mm4nder44 ($6.06 in chips)
Seat 2: Baksojor ($12.19 in chips)
Seat 3: dimon36krut ($5.81 in chips)
Seat 4: Darkymond ($5.52 in chips)
Seat 5: Aleks Ryder ($9.23 in chips)
Seat 6: YmanB ($5.21 in chips)
Baksojor: posts small blind $0.02
dimon36krut: posts big blind $0.05
*** HOLE CARDS ***
Dealt to Baksojor [7h 6d]
Darkymond: folds
Aleks Ryder: folds
YmanB: folds
C0mm4nder44: folds
Baksojor: folds
Uncalled bet ($0.03) returned to dimon36krut
dimon36krut collected $0.04 from pot
dimon36krut: doesn't show hand
*** SUMMARY ***
Total pot $0.04 | Rake $0
Seat 1: C0mm4nder44 (button) folded before Flop (didn't bet)
Seat 2: Baksojor (small blind) folded before Flop
Seat 3: dimon36krut (big blind) collected ($0.04)
Seat 4: Darkymond folded before Flop (didn't bet)
Seat 5: Aleks Ryder folded before Flop (didn't bet)
Seat 6: YmanB folded before Flop (didn't bet)


*********** # 158 **************
PokerStars Zoom Hand #174049470986:  Hold'em No Limit ($0.02/$0.05) - 2017/08/07 23:55:48 MSK [2017/08/07 16:55:48 ET]
Table 'Donati' 6-max Seat #1 is the button
Seat 1: smither83 ($7.72 in chips)
Seat 2: omgitsslave ($5.34 in chips)
Seat 3: qk rodriguez ($6.52 in chips)
Seat 4: Baksojor ($12.19 in chips)
Seat 5: vasiasul11 ($12.06 in chips)
Seat 6: MrInTerra ($5.45 in chips)
omgitsslave: posts small blind $0.02
qk rodriguez: posts big blind $0.05
*** HOLE CARDS ***
Dealt to Baksojor [5c Qd]
Baksojor: folds
vasiasul11: raises $0.05 to $0.10
MrInTerra: folds
smither83: folds
omgitsslave: folds
qk rodriguez: folds
Uncalled bet ($0.05) returned to vasiasul11
vasiasul11 collected $0.12 from pot
vasiasul11: doesn't show hand
*** SUMMARY ***
Total pot $0.12 | Rake $0
Seat 1: smither83 (button) folded before Flop (didn't bet)
Seat 2: omgitsslave (small blind) folded before Flop
Seat 3: qk rodriguez (big blind) folded before Flop
Seat 4: Baksojor folded before Flop (didn't bet)
Seat 5: vasiasul11 collected ($0.12)
Seat 6: MrInTerra folded before Flop (didn't bet)


*********** # 159 **************
PokerStars Zoom Hand #174049465361:  Hold'em No Limit ($0.02/$0.05) - 2017/08/07 23:55:39 MSK [2017/08/07 16:55:39 ET]
Table 'Donati' 6-max Seat #1 is the button
Seat 1: williamnik ($13.06 in chips)
Seat 2: Girigal ($5.68 in chips)
Seat 3: romanshepp ($7.82 in chips)
Seat 4: Stingray31 ($5.37 in chips)
Seat 5: Baksojor ($12.19 in chips)
Seat 6: FINTIFLYSHKI ($0.83 in chips)
Girigal: posts small blind $0.02
romanshepp: posts big blind $0.05
*** HOLE CARDS ***
Dealt to Baksojor [8c 7h]
Stingray31: folds
Baksojor: folds
FINTIFLYSHKI: folds
williamnik: folds
Girigal: raises $0.10 to $0.15
romanshepp: folds
Uncalled bet ($0.10) returned to Girigal
Girigal collected $0.10 from pot
Girigal: doesn't show hand
*** SUMMARY ***
Total pot $0.10 | Rake $0
Seat 1: williamnik (button) folded before Flop (didn't bet)
Seat 2: Girigal (small blind) collected ($0.10)
Seat 3: romanshepp (big blind) folded before Flop
Seat 4: Stingray31 folded before Flop (didn't bet)
Seat 5: Baksojor folded before Flop (didn't bet)
Seat 6: FINTIFLYSHKI folded before Flop (didn't bet)


*********** # 160 **************
PokerStars Zoom Hand #174049460980:  Hold'em No Limit ($0.02/$0.05) - 2017/08/07 23:55:32 MSK [2017/08/07 16:55:32 ET]
Table 'Donati' 6-max Seat #1 is the button
Seat 1: Baksojor ($12.19 in chips)
Seat 2: FAHHH168 ($5.22 in chips)
Seat 3: maxtel5 ($5.69 in chips)
Seat 4: atlandhia ($2.78 in chips)
Seat 5: gameflix ($7.04 in chips)
Seat 6: goldbunnies ($6.08 in chips)
FAHHH168: posts small blind $0.02
maxtel5: posts big blind $0.05
*** HOLE CARDS ***
Dealt to Baksojor [5d Th]
atlandhia: calls $0.05
gameflix: raises $0.15 to $0.20
goldbunnies: folds
Baksojor: folds
FAHHH168: folds
maxtel5: folds
atlandhia: calls $0.15
*** FLOP *** [Jc 6c 2c]
atlandhia: checks
gameflix: bets $0.30
atlandhia: folds
Uncalled bet ($0.30) returned to gameflix
gameflix collected $0.45 from pot
gameflix: doesn't show hand
*** SUMMARY ***
Total pot $0.47 | Rake $0.02
Board [Jc 6c 2c]
Seat 1: Baksojor (button) folded before Flop (didn't bet)
Seat 2: FAHHH168 (small blind) folded before Flop
Seat 3: maxtel5 (big blind) folded before Flop
Seat 4: atlandhia folded on the Flop
Seat 5: gameflix collected ($0.45)
Seat 6: goldbunnies folded before Flop (didn't bet)


*********** # 161 **************
PokerStars Zoom Hand #174049455979:  Hold'em No Limit ($0.02/$0.05) - 2017/08/07 23:55:24 MSK [2017/08/07 16:55:24 ET]
Table 'Donati' 6-max Seat #1 is the button
Seat 1: vitata67 ($5 in chips)
Seat 2: MrInTerra ($5.62 in chips)
Seat 3: nodarik1980 ($5.14 in chips)
Seat 4: Baksojor ($12.19 in chips)
Seat 5: grant8064 ($7.91 in chips)
Seat 6: InteRus13 ($4.31 in chips)
MrInTerra: posts small blind $0.02
nodarik1980: posts big blind $0.05
*** HOLE CARDS ***
Dealt to Baksojor [Jc Th]
Baksojor: folds
grant8064: folds
InteRus13: folds
vitata67: raises $0.10 to $0.15
MrInTerra: folds
nodarik1980: folds
Uncalled bet ($0.10) returned to vitata67
vitata67 collected $0.12 from pot
vitata67: doesn't show hand
*** SUMMARY ***
Total pot $0.12 | Rake $0
Seat 1: vitata67 (button) collected ($0.12)
Seat 2: MrInTerra (small blind) folded before Flop
Seat 3: nodarik1980 (big blind) folded before Flop
Seat 4: Baksojor folded before Flop (didn't bet)
Seat 5: grant8064 folded before Flop (didn't bet)
Seat 6: InteRus13 folded before Flop (didn't bet)


*********** # 162 **************
PokerStars Zoom Hand #174049406495:  Hold'em No Limit ($0.02/$0.05) - 2017/08/07 23:54:18 MSK [2017/08/07 16:54:18 ET]
Table 'Donati' 6-max Seat #1 is the button
Seat 1: Pahuljica37 ($4.28 in chips)
Seat 2: Baksojor ($17.19 in chips)
Seat 3: Lina6591 ($2.12 in chips)
Seat 4: kscloud ($4.20 in chips)
Seat 5: Hasan-i-Sabb ($2.61 in chips)
Seat 6: stano5 ($5 in chips)
Baksojor: posts small blind $0.02
Lina6591: posts big blind $0.05
*** HOLE CARDS ***
Dealt to Baksojor [Tc Td]
kscloud: folds
Hasan-i-Sabb: folds
stano5: raises $0.06 to $0.11
Pahuljica37: folds
Baksojor: raises $0.29 to $0.40
Lina6591: folds
stano5: calls $0.29
*** FLOP *** [8d 2c 9s]
Baksojor: bets $0.54
stano5: raises $0.86 to $1.40
Baksojor: raises $3.61 to $5.01
stano5: calls $3.20 and is all-in
Uncalled bet ($0.41) returned to Baksojor
*** TURN *** [8d 2c 9s] [Jc]
*** RIVER *** [8d 2c 9s Jc] [3s]
*** SHOW DOWN ***
Baksojor: shows [Tc Td] (a pair of Tens)
stano5: shows [9c 9d] (three of a kind, Nines)
stano5 collected $9.63 from pot
*** SUMMARY ***
Total pot $10.05 | Rake $0.42
Board [8d 2c 9s Jc 3s]
Seat 1: Pahuljica37 (button) folded before Flop (didn't bet)
Seat 2: Baksojor (small blind) showed [Tc Td] and lost with a pair of Tens
Seat 3: Lina6591 (big blind) folded before Flop
Seat 4: kscloud folded before Flop (didn't bet)
Seat 5: Hasan-i-Sabb folded before Flop (didn't bet)
Seat 6: stano5 showed [9c 9d] and won ($9.63) with three of a kind, Nines


*********** # 163 **************
PokerStars Zoom Hand #174049377913:  Hold'em No Limit ($0.02/$0.05) - 2017/08/07 23:53:41 MSK [2017/08/07 16:53:41 ET]
Table 'Donati' 6-max Seat #1 is the button
Seat 1: jeliax ($6.69 in chips)
Seat 2: My4Street ($10.37 in chips)
Seat 3: Baksojor ($17.30 in chips)
Seat 4: nippesboy ($6.20 in chips)
Seat 5: sunset1111 ($6.54 in chips)
Seat 6: 1matodor$ ($9.09 in chips)
My4Street: posts small blind $0.02
Baksojor: posts big blind $0.05
*** HOLE CARDS ***
Dealt to Baksojor [Th Ad]
nippesboy: folds
sunset1111: folds
1matodor$: folds
jeliax: raises $0.06 to $0.11
My4Street: folds
Baksojor: calls $0.06
*** FLOP *** [8c 7c Kd]
Baksojor: checks
jeliax: bets $0.06
Baksojor: folds
Uncalled bet ($0.06) returned to jeliax
jeliax collected $0.23 from pot
jeliax: doesn't show hand
*** SUMMARY ***
Total pot $0.24 | Rake $0.01
Board [8c 7c Kd]
Seat 1: jeliax (button) collected ($0.23)
Seat 2: My4Street (small blind) folded before Flop
Seat 3: Baksojor (big blind) folded on the Flop
Seat 4: nippesboy folded before Flop (didn't bet)
Seat 5: sunset1111 folded before Flop (didn't bet)
Seat 6: 1matodor$ folded before Flop (didn't bet)


*********** # 164 **************
PokerStars Zoom Hand #174049374779:  Hold'em No Limit ($0.02/$0.05) - 2017/08/07 23:53:37 MSK [2017/08/07 16:53:37 ET]
Table 'Donati' 6-max Seat #1 is the button
Seat 1: Dasha_1989 ($5.30 in chips)
Seat 2: YstrAV ($19.81 in chips)
Seat 3: Kolbert31 ($4.76 in chips)
Seat 4: Baksojor ($17.30 in chips)
Seat 5: Oscar__62176 ($6.60 in chips)
Seat 6: eduardogod ($5.42 in chips)
YstrAV: posts small blind $0.02
Kolbert31: posts big blind $0.05
*** HOLE CARDS ***
Dealt to Baksojor [8h 5h]
Baksojor: folds
Oscar__62176: folds
eduardogod: folds
Dasha_1989: raises $0.07 to $0.12
YstrAV: calls $0.10
Kolbert31: folds
*** FLOP *** [8d 6h Jh]
YstrAV: checks
Dasha_1989: checks
*** TURN *** [8d 6h Jh] [5c]
YstrAV: bets $0.10
Dasha_1989: folds
Uncalled bet ($0.10) returned to YstrAV
YstrAV collected $0.28 from pot
YstrAV: doesn't show hand
*** SUMMARY ***
Total pot $0.29 | Rake $0.01
Board [8d 6h Jh 5c]
Seat 1: Dasha_1989 (button) folded on the Turn
Seat 2: YstrAV (small blind) collected ($0.28)
Seat 3: Kolbert31 (big blind) folded before Flop
Seat 4: Baksojor folded before Flop (didn't bet)
Seat 5: Oscar__62176 folded before Flop (didn't bet)
Seat 6: eduardogod folded before Flop (didn't bet)


*********** # 165 **************
PokerStars Zoom Hand #174049371630:  Hold'em No Limit ($0.02/$0.05) - 2017/08/07 23:53:33 MSK [2017/08/07 16:53:33 ET]
Table 'Donati' 6-max Seat #1 is the button
Seat 1: Aleks Ryder ($39.21 in chips)
Seat 2: qk rodriguez ($9.09 in chips)
Seat 3: guilhermev85 ($5.41 in chips)
Seat 4: MSKLucky007 ($5.43 in chips)
Seat 5: hen1337 ($12.48 in chips)
Seat 6: Baksojor ($17.30 in chips)
qk rodriguez: posts small blind $0.02
guilhermev85: posts big blind $0.05
*** HOLE CARDS ***
Dealt to Baksojor [4d Kd]
MSKLucky007: folds
hen1337: folds
Baksojor: folds
Aleks Ryder: folds
qk rodriguez: raises $0.10 to $0.15
guilhermev85: raises $0.30 to $0.45
qk rodriguez: raises $0.65 to $1.10
guilhermev85: raises $4.31 to $5.41 and is all-in
qk rodriguez: calls $4.31
*** FLOP *** [7h Ts Qd]
*** TURN *** [7h Ts Qd] [Kh]
*** RIVER *** [7h Ts Qd Kh] [Ks]
*** SHOW DOWN ***
qk rodriguez: shows [Ad Ac] (two pair, Aces and Kings)
guilhermev85: shows [Qc As] (two pair, Kings and Queens)
qk rodriguez collected $10.37 from pot
*** SUMMARY ***
Total pot $10.82 | Rake $0.45
Board [7h Ts Qd Kh Ks]
Seat 1: Aleks Ryder (button) folded before Flop (didn't bet)
Seat 2: qk rodriguez (small blind) showed [Ad Ac] and won ($10.37) with two pair, Aces and Kings
Seat 3: guilhermev85 (big blind) showed [Qc As] and lost with two pair, Kings and Queens
Seat 4: MSKLucky007 folded before Flop (didn't bet)
Seat 5: hen1337 folded before Flop (didn't bet)
Seat 6: Baksojor folded before Flop (didn't bet)


*********** # 166 **************
PokerStars Zoom Hand #174049368509:  Hold'em No Limit ($0.02/$0.05) - 2017/08/07 23:53:29 MSK [2017/08/07 16:53:29 ET]
Table 'Donati' 6-max Seat #1 is the button
Seat 1: plasencia345 ($6.95 in chips)
Seat 2: zack20379 ($4.95 in chips)
Seat 3: BabyCry777 ($7.40 in chips)
Seat 4: Baksojor ($17.30 in chips)
Seat 5: valdemar803 ($2.60 in chips)
Seat 6: Dasha_1989 ($6.21 in chips)
zack20379: posts small blind $0.02
BabyCry777: posts big blind $0.05
*** HOLE CARDS ***
Dealt to Baksojor [Ad 8h]
Baksojor: folds
valdemar803: folds
Dasha_1989: folds
plasencia345: folds
zack20379: folds
Uncalled bet ($0.03) returned to BabyCry777
BabyCry777 collected $0.04 from pot
BabyCry777: doesn't show hand
*** SUMMARY ***
Total pot $0.04 | Rake $0
Seat 1: plasencia345 (button) folded before Flop (didn't bet)
Seat 2: zack20379 (small blind) folded before Flop
Seat 3: BabyCry777 (big blind) collected ($0.04)
Seat 4: Baksojor folded before Flop (didn't bet)
Seat 5: valdemar803 folded before Flop (didn't bet)
Seat 6: Dasha_1989 folded before Flop (didn't bet)


*********** # 167 **************
PokerStars Zoom Hand #174049357802:  Hold'em No Limit ($0.02/$0.05) - 2017/08/07 23:53:15 MSK [2017/08/07 16:53:15 ET]
Table 'Donati' 6-max Seat #1 is the button
Seat 1: Baksojor ($17.30 in chips)
Seat 2: jockl ($12.07 in chips)
Seat 3: indian2801 ($2.50 in chips)
Seat 4: 1matodor$ ($5.38 in chips)
Seat 5: Lina6591 ($0.98 in chips)
Seat 6: Dava 0060 ($4.52 in chips)
jockl: posts small blind $0.02
indian2801: posts big blind $0.05
*** HOLE CARDS ***
Dealt to Baksojor [8c 5d]
1matodor$: folds
Lina6591: raises $0.05 to $0.10
Dava 0060: raises $0.27 to $0.37
Baksojor: folds
jockl: folds
indian2801: folds
Lina6591: calls $0.27
*** FLOP *** [Ks 3d Jc]
Lina6591: checks
Dava 0060: checks
*** TURN *** [Ks 3d Jc] [2d]
Lina6591: checks
Dava 0060: checks
*** RIVER *** [Ks 3d Jc 2d] [3c]
Lina6591: checks
Dava 0060: bets $0.39
Lina6591: folds
Uncalled bet ($0.39) returned to Dava 0060
Dava 0060 collected $0.78 from pot
Dava 0060: doesn't show hand
*** SUMMARY ***
Total pot $0.81 | Rake $0.03
Board [Ks 3d Jc 2d 3c]
Seat 1: Baksojor (button) folded before Flop (didn't bet)
Seat 2: jockl (small blind) folded before Flop
Seat 3: indian2801 (big blind) folded before Flop
Seat 4: 1matodor$ folded before Flop (didn't bet)
Seat 5: Lina6591 folded on the River
Seat 6: Dava 0060 collected ($0.78)


*********** # 168 **************
PokerStars Zoom Hand #174049354700:  Hold'em No Limit ($0.02/$0.05) - 2017/08/07 23:53:11 MSK [2017/08/07 16:53:11 ET]
Table 'Donati' 6-max Seat #1 is the button
Seat 1: labus80n ($10.30 in chips)
Seat 2: IldarD86 ($8.13 in chips)
Seat 3: Pahuljica37 ($5.28 in chips)
Seat 4: Mikaeus ($5.20 in chips)
Seat 5: gesa.lienhop ($5.69 in chips)
Seat 6: Baksojor ($17.30 in chips)
IldarD86: posts small blind $0.02
Pahuljica37: posts big blind $0.05
*** HOLE CARDS ***
Dealt to Baksojor [Qh 2c]
Mikaeus: folds
gesa.lienhop: folds
Baksojor: folds
labus80n: folds
IldarD86: folds
Uncalled bet ($0.03) returned to Pahuljica37
Pahuljica37 collected $0.04 from pot
Pahuljica37: doesn't show hand
*** SUMMARY ***
Total pot $0.04 | Rake $0
Seat 1: labus80n (button) folded before Flop (didn't bet)
Seat 2: IldarD86 (small blind) folded before Flop
Seat 3: Pahuljica37 (big blind) collected ($0.04)
Seat 4: Mikaeus folded before Flop (didn't bet)
Seat 5: gesa.lienhop folded before Flop (didn't bet)
Seat 6: Baksojor folded before Flop (didn't bet)


*********** # 169 **************
PokerStars Zoom Hand #174049342328:  Hold'em No Limit ($0.02/$0.05) - 2017/08/07 23:52:55 MSK [2017/08/07 16:52:55 ET]
Table 'Donati' 6-max Seat #1 is the button
Seat 1: Toffsla ($11.38 in chips)
Seat 2: Taron-gao ($5.24 in chips)
Seat 3: Baksojor ($17.35 in chips)
Seat 4: FINTIFLYSHKI ($4.75 in chips)
Seat 5: Friadent ($5.88 in chips)
Seat 6: Droncha ($15.94 in chips)
Taron-gao: posts small blind $0.02
Baksojor: posts big blind $0.05
*** HOLE CARDS ***
Dealt to Baksojor [2c 4c]
FINTIFLYSHKI: folds
Friadent: folds
Droncha: folds
Toffsla: folds
Taron-gao: raises $0.10 to $0.15
Baksojor: folds
Uncalled bet ($0.10) returned to Taron-gao
Taron-gao collected $0.10 from pot
Taron-gao: doesn't show hand
*** SUMMARY ***
Total pot $0.10 | Rake $0
Seat 1: Toffsla (button) folded before Flop (didn't bet)
Seat 2: Taron-gao (small blind) collected ($0.10)
Seat 3: Baksojor (big blind) folded before Flop
Seat 4: FINTIFLYSHKI folded before Flop (didn't bet)
Seat 5: Friadent folded before Flop (didn't bet)
Seat 6: Droncha folded before Flop (didn't bet)


*********** # 170 **************
PokerStars Zoom Hand #174049336153:  Hold'em No Limit ($0.02/$0.05) - 2017/08/07 23:52:47 MSK [2017/08/07 16:52:47 ET]
Table 'Donati' 6-max Seat #1 is the button
Seat 1: qk rodriguez ($6.54 in chips)
Seat 2: Baksojor ($17.37 in chips)
Seat 3: Dimexp ($3.69 in chips)
Seat 4: JFJQ ($2.86 in chips)
Seat 5: Hell Knife ($5 in chips)
Seat 6: gambler4f ($13.48 in chips)
Baksojor: posts small blind $0.02
Dimexp: posts big blind $0.05
*** HOLE CARDS ***
Dealt to Baksojor [7c 2s]
JFJQ: folds
Hell Knife: folds
gambler4f: raises $0.06 to $0.11
qk rodriguez: folds
Baksojor: folds
Dimexp: calls $0.06
*** FLOP *** [Td Ah Kc]
Dimexp: checks
gambler4f: bets $0.17
Dimexp: raises $0.17 to $0.34
gambler4f: raises $0.50 to $0.84
Dimexp: calls $0.50
*** TURN *** [Td Ah Kc] [9s]
Dimexp: bets $0.90
gambler4f: calls $0.90
*** RIVER *** [Td Ah Kc 9s] [8c]
Dimexp: bets $1.80
gambler4f: calls $1.80
*** SHOW DOWN ***
Dimexp: shows [Qh Js] (a straight, Ten to Ace)
gambler4f: mucks hand
Dimexp collected $7.02 from pot
*** SUMMARY ***
Total pot $7.32 | Rake $0.30
Board [Td Ah Kc 9s 8c]
Seat 1: qk rodriguez (button) folded before Flop (didn't bet)
Seat 2: Baksojor (small blind) folded before Flop
Seat 3: Dimexp (big blind) showed [Qh Js] and won ($7.02) with a straight, Ten to Ace
Seat 4: JFJQ folded before Flop (didn't bet)
Seat 5: Hell Knife folded before Flop (didn't bet)
Seat 6: gambler4f mucked [Ac As]


*********** # 171 **************
PokerStars Zoom Hand #174049332995:  Hold'em No Limit ($0.02/$0.05) - 2017/08/07 23:52:43 MSK [2017/08/07 16:52:43 ET]
Table 'Donati' 6-max Seat #1 is the button
Seat 1: Oscar__62176 ($10.84 in chips)
Seat 2: Feyqdoi ($5.02 in chips)
Seat 3: IVE244 ($5.47 in chips)
Seat 4: Baksojor ($17.37 in chips)
Seat 5: jockl ($15.31 in chips)
Seat 6: ElbowsKnees ($5.07 in chips)
Feyqdoi: posts small blind $0.02
IVE244: posts big blind $0.05
*** HOLE CARDS ***
Dealt to Baksojor [As 3d]
Baksojor: folds
jockl: folds
ElbowsKnees: folds
Oscar__62176: raises $0.05 to $0.10
Feyqdoi: folds
IVE244: folds
Uncalled bet ($0.05) returned to Oscar__62176
Oscar__62176 collected $0.12 from pot
Oscar__62176: doesn't show hand
*** SUMMARY ***
Total pot $0.12 | Rake $0
Seat 1: Oscar__62176 (button) collected ($0.12)
Seat 2: Feyqdoi (small blind) folded before Flop
Seat 3: IVE244 (big blind) folded before Flop
Seat 4: Baksojor folded before Flop (didn't bet)
Seat 5: jockl folded before Flop (didn't bet)
Seat 6: ElbowsKnees folded before Flop (didn't bet)


*********** # 172 **************
PokerStars Zoom Hand #174049329861:  Hold'em No Limit ($0.02/$0.05) - 2017/08/07 23:52:39 MSK [2017/08/07 16:52:39 ET]
Table 'Donati' 6-max Seat #1 is the button
Seat 1: mthies ($5.63 in chips)
Seat 2: vad1963 ($4.73 in chips)
Seat 3: Levmachinexx ($5.25 in chips)
Seat 4: PayForSee ($17 in chips)
Seat 5: Baksojor ($17.37 in chips)
Seat 6: stakoms82 ($8.95 in chips)
vad1963: posts small blind $0.02
Levmachinexx: posts big blind $0.05
*** HOLE CARDS ***
Dealt to Baksojor [Kc 6d]
PayForSee: folds
Baksojor: folds
stakoms82: folds
mthies: raises $0.07 to $0.12
vad1963: folds
Levmachinexx: folds
Uncalled bet ($0.07) returned to mthies
mthies collected $0.12 from pot
mthies: doesn't show hand
*** SUMMARY ***
Total pot $0.12 | Rake $0
Seat 1: mthies (button) collected ($0.12)
Seat 2: vad1963 (small blind) folded before Flop
Seat 3: Levmachinexx (big blind) folded before Flop
Seat 4: PayForSee folded before Flop (didn't bet)
Seat 5: Baksojor folded before Flop (didn't bet)
Seat 6: stakoms82 folded before Flop (didn't bet)


*********** # 173 **************
PokerStars Zoom Hand #174049292636:  Hold'em No Limit ($0.02/$0.05) - 2017/08/07 23:51:51 MSK [2017/08/07 16:51:51 ET]
Table 'Donati' 6-max Seat #1 is the button
Seat 1: Baksojor ($17 in chips)
Seat 2: Valerij V.S. ($2.64 in chips)
Seat 3: PayForSee ($5.34 in chips)
Seat 4: AlberTSifon ($5.54 in chips)
Seat 5: 777serg58 ($7.23 in chips)
Seat 6: ElbowsKnees ($5.78 in chips)
Valerij V.S.: posts small blind $0.02
PayForSee: posts big blind $0.05
*** HOLE CARDS ***
Dealt to Baksojor [As Kc]
AlberTSifon: folds
777serg58: calls $0.05
ElbowsKnees: raises $0.20 to $0.25
Baksojor: raises $0.50 to $0.75
Valerij V.S.: folds
PayForSee: folds
777serg58: folds
ElbowsKnees: folds
Uncalled bet ($0.50) returned to Baksojor
Baksojor collected $0.62 from pot
Baksojor: doesn't show hand
*** SUMMARY ***
Total pot $0.62 | Rake $0
Seat 1: Baksojor (button) collected ($0.62)
Seat 2: Valerij V.S. (small blind) folded before Flop
Seat 3: PayForSee (big blind) folded before Flop
Seat 4: AlberTSifon folded before Flop (didn't bet)
Seat 5: 777serg58 folded before Flop
Seat 6: ElbowsKnees folded before Flop


*********** # 174 **************
PokerStars Zoom Hand #174049282390:  Hold'em No Limit ($0.02/$0.05) - 2017/08/07 23:51:38 MSK [2017/08/07 16:51:38 ET]
Table 'Donati' 6-max Seat #1 is the button
Seat 1: MárioRJ ($5.46 in chips)
Seat 2: Naosky ($5.30 in chips)
Seat 3: sunset1111 ($5.16 in chips)
Seat 4: schredinger ($3.94 in chips)
Seat 5: Baksojor ($16.93 in chips)
Seat 6: Oscar__62176 ($10.84 in chips)
Naosky: posts small blind $0.02
sunset1111: posts big blind $0.05
*** HOLE CARDS ***
Dealt to Baksojor [Th Ah]
schredinger: folds
Baksojor: raises $0.10 to $0.15
Oscar__62176: folds
MárioRJ: folds
Naosky: folds
sunset1111: folds
Uncalled bet ($0.10) returned to Baksojor
Baksojor collected $0.12 from pot
Baksojor: doesn't show hand
*** SUMMARY ***
Total pot $0.12 | Rake $0
Seat 1: MárioRJ (button) folded before Flop (didn't bet)
Seat 2: Naosky (small blind) folded before Flop
Seat 3: sunset1111 (big blind) folded before Flop
Seat 4: schredinger folded before Flop (didn't bet)
Seat 5: Baksojor collected ($0.12)
Seat 6: Oscar__62176 folded before Flop (didn't bet)


*********** # 175 **************
PokerStars Zoom Hand #174049279316:  Hold'em No Limit ($0.02/$0.05) - 2017/08/07 23:51:34 MSK [2017/08/07 16:51:34 ET]
Table 'Donati' 6-max Seat #1 is the button
Seat 1: Misha250595 ($10.28 in chips)
Seat 2: Monsterpot13 ($2.28 in chips)
Seat 3: 1matodor$ ($8.02 in chips)
Seat 4: Demon31222 ($5 in chips)
Seat 5: sunset1111 ($5.16 in chips)
Seat 6: Baksojor ($16.93 in chips)
Monsterpot13: posts small blind $0.02
1matodor$: posts big blind $0.05
*** HOLE CARDS ***
Dealt to Baksojor [3c Qs]
Demon31222: folds
sunset1111: folds
Baksojor: folds
Misha250595: folds
Monsterpot13: folds
Uncalled bet ($0.03) returned to 1matodor$
1matodor$ collected $0.04 from pot
1matodor$: doesn't show hand
*** SUMMARY ***
Total pot $0.04 | Rake $0
Seat 1: Misha250595 (button) folded before Flop (didn't bet)
Seat 2: Monsterpot13 (small blind) folded before Flop
Seat 3: 1matodor$ (big blind) collected ($0.04)
Seat 4: Demon31222 folded before Flop (didn't bet)
Seat 5: sunset1111 folded before Flop (didn't bet)
Seat 6: Baksojor folded before Flop (didn't bet)


*********** # 176 **************
PokerStars Zoom Hand #174049269242:  Hold'em No Limit ($0.02/$0.05) - 2017/08/07 23:51:21 MSK [2017/08/07 16:51:21 ET]
Table 'Donati' 6-max Seat #1 is the button
Seat 1: carpente285 ($2.56 in chips)
Seat 2: nodarik1980 ($5 in chips)
Seat 3: Baksojor ($16.91 in chips)
Seat 4: Avallonis ($5.24 in chips)
Seat 5: filipzic ($8.40 in chips)
Seat 6: MiyagiMaster ($5.02 in chips)
nodarik1980: posts small blind $0.02
Baksojor: posts big blind $0.05
*** HOLE CARDS ***
Dealt to Baksojor [2c Jc]
Avallonis: folds
filipzic: folds
MiyagiMaster: folds
carpente285: folds
nodarik1980: folds
Uncalled bet ($0.03) returned to Baksojor
Baksojor collected $0.04 from pot
Baksojor: doesn't show hand
*** SUMMARY ***
Total pot $0.04 | Rake $0
Seat 1: carpente285 (button) folded before Flop (didn't bet)
Seat 2: nodarik1980 (small blind) folded before Flop
Seat 3: Baksojor (big blind) collected ($0.04)
Seat 4: Avallonis folded before Flop (didn't bet)
Seat 5: filipzic folded before Flop (didn't bet)
Seat 6: MiyagiMaster folded before Flop (didn't bet)


*********** # 177 **************
PokerStars Zoom Hand #174049265130:  Hold'em No Limit ($0.02/$0.05) - 2017/08/07 23:51:16 MSK [2017/08/07 16:51:16 ET]
Table 'Donati' 6-max Seat #1 is the button
Seat 1: StephBpee ($3.90 in chips)
Seat 2: Sviat47 ($4.80 in chips)
Seat 3: NEAVH100 ($4.60 in chips)
Seat 4: hen1337 ($7.77 in chips)
Seat 5: Baksojor ($16.91 in chips)
Seat 6: V.S.151 ($10.54 in chips)
Sviat47: posts small blind $0.02
NEAVH100: posts big blind $0.05
*** HOLE CARDS ***
Dealt to Baksojor [8d Qh]
hen1337: folds
Baksojor: folds
V.S.151: folds
StephBpee: folds
Sviat47: folds
Uncalled bet ($0.03) returned to NEAVH100
NEAVH100 collected $0.04 from pot
NEAVH100: doesn't show hand
*** SUMMARY ***
Total pot $0.04 | Rake $0
Seat 1: StephBpee (button) folded before Flop (didn't bet)
Seat 2: Sviat47 (small blind) folded before Flop
Seat 3: NEAVH100 (big blind) collected ($0.04)
Seat 4: hen1337 folded before Flop (didn't bet)
Seat 5: Baksojor folded before Flop (didn't bet)
Seat 6: V.S.151 folded before Flop (didn't bet)


*********** # 178 **************
PokerStars Zoom Hand #174049225949:  Hold'em No Limit ($0.02/$0.05) - 2017/08/07 23:50:26 MSK [2017/08/07 16:50:26 ET]
Table 'Donati' 6-max Seat #1 is the button
Seat 1: Baksojor ($17.16 in chips)
Seat 2: bigamus ($6.06 in chips)
Seat 3: Lina6591 ($2.73 in chips)
Seat 4: Sobo030 ($6.94 in chips)
Seat 5: Verros1991 ($6.94 in chips)
Seat 6: Linkk1 ($5 in chips)
bigamus: posts small blind $0.02
Lina6591: posts big blind $0.05
*** HOLE CARDS ***
Dealt to Baksojor [9h Ac]
Sobo030: folds
Verros1991: folds
Linkk1: folds
Baksojor: raises $0.05 to $0.10
bigamus: calls $0.08
Lina6591: folds
*** FLOP *** [6d 8s Tc]
bigamus: checks
Baksojor: bets $0.15
bigamus: raises $0.25 to $0.40
Baksojor: folds
Uncalled bet ($0.25) returned to bigamus
bigamus collected $0.53 from pot
bigamus: doesn't show hand
*** SUMMARY ***
Total pot $0.55 | Rake $0.02
Board [6d 8s Tc]
Seat 1: Baksojor (button) folded on the Flop
Seat 2: bigamus (small blind) collected ($0.53)
Seat 3: Lina6591 (big blind) folded before Flop
Seat 4: Sobo030 folded before Flop (didn't bet)
Seat 5: Verros1991 folded before Flop (didn't bet)
Seat 6: Linkk1 folded before Flop (didn't bet)


*********** # 179 **************
PokerStars Zoom Hand #174049180251:  Hold'em No Limit ($0.02/$0.05) - 2017/08/07 23:49:29 MSK [2017/08/07 16:49:29 ET]
Table 'Donati' 6-max Seat #1 is the button
Seat 1: AKKbank ($5.89 in chips)
Seat 2: Baksojor ($16.45 in chips)
Seat 3: alexnn15 ($8.48 in chips)
Seat 4: IldarD86 ($7.77 in chips)
Seat 5: aqvarel80 ($4.99 in chips)
Seat 6: Jack123985 ($5.03 in chips)
Baksojor: posts small blind $0.02
alexnn15: posts big blind $0.05
*** HOLE CARDS ***
Dealt to Baksojor [7h 6h]
IldarD86: folds
aqvarel80: calls $0.05
Jack123985: folds
AKKbank: raises $0.15 to $0.20
Baksojor: calls $0.18
alexnn15: folds
aqvarel80: calls $0.15
*** FLOP *** [7s Td 3h]
Baksojor: checks
aqvarel80: checks
AKKbank: bets $0.31
Baksojor: calls $0.31
aqvarel80: folds
*** TURN *** [7s Td 3h] [9d]
Baksojor: checks
AKKbank: checks
*** RIVER *** [7s Td 3h 9d] [Jc]
Baksojor: checks
AKKbank: checks
*** SHOW DOWN ***
Baksojor: shows [7h 6h] (a pair of Sevens)
AKKbank: mucks hand
Baksojor collected $1.22 from pot
*** SUMMARY ***
Total pot $1.27 | Rake $0.05
Board [7s Td 3h 9d Jc]
Seat 1: AKKbank (button) mucked [Ac Qs]
Seat 2: Baksojor (small blind) showed [7h 6h] and won ($1.22) with a pair of Sevens
Seat 3: alexnn15 (big blind) folded before Flop
Seat 4: IldarD86 folded before Flop (didn't bet)
Seat 5: aqvarel80 folded on the Flop
Seat 6: Jack123985 folded before Flop (didn't bet)


*********** # 180 **************
PokerStars Zoom Hand #174049144874:  Hold'em No Limit ($0.02/$0.05) - 2017/08/07 23:48:48 MSK [2017/08/07 16:48:48 ET]
Table 'Donati' 6-max Seat #1 is the button
Seat 1: fam007007 ($7.79 in chips)
Seat 2: Pechkin85 ($5 in chips)
Seat 3: Yoeram ($5 in chips)
Seat 4: V.S.151 ($4.76 in chips)
Seat 5: Baksojor ($16.60 in chips)
Seat 6: Scar_spb ($9.45 in chips)
Pechkin85: posts small blind $0.02
Yoeram: posts big blind $0.05
*** HOLE CARDS ***
Dealt to Baksojor [4c 4d]
V.S.151: raises $0.10 to $0.15
Baksojor: calls $0.15
Scar_spb: folds
fam007007: calls $0.15
Pechkin85: calls $0.13
Yoeram: folds
*** FLOP *** [8h Jd Jc]
Pechkin85: checks
V.S.151: checks
Baksojor: checks
fam007007: checks
*** TURN *** [8h Jd Jc] [5s]
Pechkin85: bets $0.47
V.S.151: calls $0.47
Baksojor: folds
fam007007: folds
*** RIVER *** [8h Jd Jc 5s] [6s]
Pechkin85: checks
V.S.151: checks
*** SHOW DOWN ***
Pechkin85: shows [9s Ts] (a pair of Jacks)
V.S.151: shows [Qh Qs] (two pair, Queens and Jacks)
V.S.151 collected $1.52 from pot
*** SUMMARY ***
Total pot $1.59 | Rake $0.07
Board [8h Jd Jc 5s 6s]
Seat 1: fam007007 (button) folded on the Turn
Seat 2: Pechkin85 (small blind) showed [9s Ts] and lost with a pair of Jacks
Seat 3: Yoeram (big blind) folded before Flop
Seat 4: V.S.151 showed [Qh Qs] and won ($1.52) with two pair, Queens and Jacks
Seat 5: Baksojor folded on the Turn
Seat 6: Scar_spb folded before Flop (didn't bet)


*********** # 181 **************
PokerStars Zoom Hand #174049042193:  Hold'em No Limit ($0.02/$0.05) - 2017/08/07 23:46:53 MSK [2017/08/07 16:46:53 ET]
Table 'Donati' 6-max Seat #1 is the button
Seat 1: Igor22913 ($6.10 in chips)
Seat 2: ULTRAST87 ($5.31 in chips)
Seat 3: Baksojor ($18.11 in chips)
Seat 4: Huk3k ($6.55 in chips)
Seat 5: Oscar__62176 ($5.16 in chips)
Seat 6: biv12 ($4.13 in chips)
ULTRAST87: posts small blind $0.02
Baksojor: posts big blind $0.05
*** HOLE CARDS ***
Dealt to Baksojor [Kd Kh]
Huk3k: calls $0.05
Oscar__62176: folds
biv12: folds
Igor22913: folds
ULTRAST87: raises $0.15 to $0.20
Baksojor: raises $0.45 to $0.65
Huk3k: folds
ULTRAST87: calls $0.45
*** FLOP *** [5d 9s Qs]
ULTRAST87: checks
Baksojor: bets $0.86
ULTRAST87: calls $0.86
*** TURN *** [5d 9s Qs] [Ac]
ULTRAST87: checks
Baksojor: checks
*** RIVER *** [5d 9s Qs Ac] [Tc]
ULTRAST87: bets $1.68
Baksojor: folds
Uncalled bet ($1.68) returned to ULTRAST87
ULTRAST87 collected $2.94 from pot
ULTRAST87: doesn't show hand
*** SUMMARY ***
Total pot $3.07 | Rake $0.13
Board [5d 9s Qs Ac Tc]
Seat 1: Igor22913 (button) folded before Flop (didn't bet)
Seat 2: ULTRAST87 (small blind) collected ($2.94)
Seat 3: Baksojor (big blind) folded on the River
Seat 4: Huk3k folded before Flop
Seat 5: Oscar__62176 folded before Flop (didn't bet)
Seat 6: biv12 folded before Flop (didn't bet)


*********** # 182 **************
PokerStars Zoom Hand #174049037560:  Hold'em No Limit ($0.02/$0.05) - 2017/08/07 23:46:47 MSK [2017/08/07 16:46:47 ET]
Table 'Donati' 6-max Seat #1 is the button
Seat 1: fam007007 ($4.86 in chips)
Seat 2: sannitar ($5.94 in chips)
Seat 3: joysaa ($4.98 in chips)
Seat 4: ksrepin ($21.68 in chips)
Seat 5: fevpez ($4.55 in chips)
Seat 6: Baksojor ($18.11 in chips)
sannitar: posts small blind $0.02
joysaa: posts big blind $0.05
*** HOLE CARDS ***
Dealt to Baksojor [2d Kc]
ksrepin: folds
fevpez: folds
Baksojor: folds
fam007007: folds
sannitar: folds
Uncalled bet ($0.03) returned to joysaa
joysaa collected $0.04 from pot
joysaa: doesn't show hand
*** SUMMARY ***
Total pot $0.04 | Rake $0
Seat 1: fam007007 (button) folded before Flop (didn't bet)
Seat 2: sannitar (small blind) folded before Flop
Seat 3: joysaa (big blind) collected ($0.04)
Seat 4: ksrepin folded before Flop (didn't bet)
Seat 5: fevpez folded before Flop (didn't bet)
Seat 6: Baksojor folded before Flop (didn't bet)


*********** # 183 **************
PokerStars Zoom Hand #174049031344:  Hold'em No Limit ($0.02/$0.05) - 2017/08/07 23:46:39 MSK [2017/08/07 16:46:39 ET]
Table 'Donati' 6-max Seat #1 is the button
Seat 1: boksiukas ($10.67 in chips)
Seat 2: Baksojor ($18.13 in chips)
Seat 3: InteRus13 ($6.61 in chips)
Seat 4: utegil ($1.14 in chips)
Seat 5: 007x2 ($5.80 in chips)
Seat 6: qk rodriguez ($8.46 in chips)
Baksojor: posts small blind $0.02
InteRus13: posts big blind $0.05
*** HOLE CARDS ***
Dealt to Baksojor [6s Js]
utegil: calls $0.05
007x2: folds
qk rodriguez: folds
boksiukas: folds
Baksojor: folds
InteRus13: checks
*** FLOP *** [Th Kc 9s]
InteRus13: checks
utegil: bets $0.05
InteRus13: folds
Uncalled bet ($0.05) returned to utegil
utegil collected $0.12 from pot
utegil: doesn't show hand
*** SUMMARY ***
Total pot $0.12 | Rake $0
Board [Th Kc 9s]
Seat 1: boksiukas (button) folded before Flop (didn't bet)
Seat 2: Baksojor (small blind) folded before Flop
Seat 3: InteRus13 (big blind) folded on the Flop
Seat 4: utegil collected ($0.12)
Seat 5: 007x2 folded before Flop (didn't bet)
Seat 6: qk rodriguez folded before Flop (didn't bet)


*********** # 184 **************
PokerStars Zoom Hand #174049011177:  Hold'em No Limit ($0.02/$0.05) - 2017/08/07 23:46:13 MSK [2017/08/07 16:46:13 ET]
Table 'Donati' 6-max Seat #1 is the button
Seat 1: Baksojor ($18.02 in chips)
Seat 2: thaddäus29 ($4.64 in chips)
Seat 3: Sathar123 ($5.14 in chips)
Seat 4: kam22.cz ($5.09 in chips)
Seat 5: Mr_Wallker ($2.71 in chips)
Seat 6: e2m8 ($4.84 in chips)
thaddäus29: posts small blind $0.02
Sathar123: posts big blind $0.05
*** HOLE CARDS ***
Dealt to Baksojor [8h Ah]
kam22.cz: folds
Mr_Wallker: folds
e2m8: folds
Baksojor: raises $0.05 to $0.10
thaddäus29: folds
Sathar123: calls $0.05
*** FLOP *** [5d 9h 4h]
Sathar123: checks
Baksojor: bets $0.14
Sathar123: folds
Uncalled bet ($0.14) returned to Baksojor
Baksojor collected $0.21 from pot
Baksojor: doesn't show hand
*** SUMMARY ***
Total pot $0.22 | Rake $0.01
Board [5d 9h 4h]
Seat 1: Baksojor (button) collected ($0.21)
Seat 2: thaddäus29 (small blind) folded before Flop
Seat 3: Sathar123 (big blind) folded on the Flop
Seat 4: kam22.cz folded before Flop (didn't bet)
Seat 5: Mr_Wallker folded before Flop (didn't bet)
Seat 6: e2m8 folded before Flop (didn't bet)


*********** # 185 **************
PokerStars Zoom Hand #174049008065:  Hold'em No Limit ($0.02/$0.05) - 2017/08/07 23:46:09 MSK [2017/08/07 16:46:09 ET]
Table 'Donati' 6-max Seat #1 is the button
Seat 1: smither83 ($3.69 in chips)
Seat 2: Suzibelaa ($5.46 in chips)
Seat 3: AndreyK11 ($5 in chips)
Seat 4: Baksojor ($18.02 in chips)
Seat 5: hen1337 ($8.29 in chips)
Seat 6: Naosky ($8.26 in chips)
Suzibelaa: posts small blind $0.02
AndreyK11: posts big blind $0.05
*** HOLE CARDS ***
Dealt to Baksojor [8h 5h]
Baksojor: folds
hen1337: folds
Naosky: raises $0.10 to $0.15
smither83: folds
Suzibelaa: folds
AndreyK11: raises $0.35 to $0.50
Naosky: folds
Uncalled bet ($0.35) returned to AndreyK11
AndreyK11 collected $0.32 from pot
AndreyK11: doesn't show hand
*** SUMMARY ***
Total pot $0.32 | Rake $0
Seat 1: smither83 (button) folded before Flop (didn't bet)
Seat 2: Suzibelaa (small blind) folded before Flop
Seat 3: AndreyK11 (big blind) collected ($0.32)
Seat 4: Baksojor folded before Flop (didn't bet)
Seat 5: hen1337 folded before Flop (didn't bet)
Seat 6: Naosky folded before Flop


*********** # 186 **************
PokerStars Zoom Hand #174049005017:  Hold'em No Limit ($0.02/$0.05) - 2017/08/07 23:46:05 MSK [2017/08/07 16:46:05 ET]
Table 'Donati' 6-max Seat #1 is the button
Seat 1: Feyqdoi ($9.86 in chips)
Seat 2: SergeySURK ($5.38 in chips)
Seat 3: P.J.Shaytan ($5.23 in chips)
Seat 4: mrGold443 ($5 in chips)
Seat 5: McDabr ($4.24 in chips)
Seat 6: Baksojor ($18.02 in chips)
SergeySURK: posts small blind $0.02
P.J.Shaytan: posts big blind $0.05
*** HOLE CARDS ***
Dealt to Baksojor [5s 6d]
mrGold443: folds
McDabr: folds
Baksojor: folds
Feyqdoi: raises $0.07 to $0.12
SergeySURK: folds
P.J.Shaytan: raises $0.43 to $0.55
Feyqdoi: folds
Uncalled bet ($0.43) returned to P.J.Shaytan
P.J.Shaytan collected $0.26 from pot
P.J.Shaytan: doesn't show hand
*** SUMMARY ***
Total pot $0.26 | Rake $0
Seat 1: Feyqdoi (button) folded before Flop
Seat 2: SergeySURK (small blind) folded before Flop
Seat 3: P.J.Shaytan (big blind) collected ($0.26)
Seat 4: mrGold443 folded before Flop (didn't bet)
Seat 5: McDabr folded before Flop (didn't bet)
Seat 6: Baksojor folded before Flop (didn't bet)


*********** # 187 **************
PokerStars Zoom Hand #174048992507:  Hold'em No Limit ($0.02/$0.05) - 2017/08/07 23:45:49 MSK [2017/08/07 16:45:49 ET]
Table 'Donati' 6-max Seat #1 is the button
Seat 1: Mikaeus ($9.07 in chips)
Seat 2: BrainGuru ($7.10 in chips)
Seat 3: Baksojor ($18.07 in chips)
Seat 4: gesa.lienhop ($5.18 in chips)
Seat 5: TrotiLo ($13.92 in chips)
Seat 6: KCH288 ($5.28 in chips)
BrainGuru: posts small blind $0.02
Baksojor: posts big blind $0.05
*** HOLE CARDS ***
Dealt to Baksojor [5d 3h]
gesa.lienhop: folds
TrotiLo: folds
KCH288: folds
Mikaeus: raises $0.07 to $0.12
BrainGuru: folds
Baksojor: folds
Uncalled bet ($0.07) returned to Mikaeus
Mikaeus collected $0.12 from pot
Mikaeus: doesn't show hand
*** SUMMARY ***
Total pot $0.12 | Rake $0
Seat 1: Mikaeus (button) collected ($0.12)
Seat 2: BrainGuru (small blind) folded before Flop
Seat 3: Baksojor (big blind) folded before Flop
Seat 4: gesa.lienhop folded before Flop (didn't bet)
Seat 5: TrotiLo folded before Flop (didn't bet)
Seat 6: KCH288 folded before Flop (didn't bet)


*********** # 188 **************
PokerStars Zoom Hand #174048989319:  Hold'em No Limit ($0.02/$0.05) - 2017/08/07 23:45:45 MSK [2017/08/07 16:45:45 ET]
Table 'Donati' 6-max Seat #1 is the button
Seat 1: jeliax ($5.23 in chips)
Seat 2: Majkee88 ($5.19 in chips)
Seat 3: Batovs ($6.29 in chips)
Seat 4: Baksojor ($18.07 in chips)
Seat 5: thaddäus29 ($4.69 in chips)
Seat 6: reibejk ($10.78 in chips)
Majkee88: posts small blind $0.02
Batovs: posts big blind $0.05
*** HOLE CARDS ***
Dealt to Baksojor [2s 5c]
Baksojor: folds
thaddäus29: folds
reibejk: folds
jeliax: folds
Majkee88: folds
Uncalled bet ($0.03) returned to Batovs
Batovs collected $0.04 from pot
Batovs: doesn't show hand
*** SUMMARY ***
Total pot $0.04 | Rake $0
Seat 1: jeliax (button) folded before Flop (didn't bet)
Seat 2: Majkee88 (small blind) folded before Flop
Seat 3: Batovs (big blind) collected ($0.04)
Seat 4: Baksojor folded before Flop (didn't bet)
Seat 5: thaddäus29 folded before Flop (didn't bet)
Seat 6: reibejk folded before Flop (didn't bet)


*********** # 189 **************
PokerStars Zoom Hand #174048945016:  Hold'em No Limit ($0.02/$0.05) - 2017/08/07 23:44:48 MSK [2017/08/07 16:44:48 ET]
Table 'Donati' 6-max Seat #1 is the button
Seat 1: Baksojor ($17.26 in chips)
Seat 2: Pechkin85 ($5 in chips)
Seat 3: Myrryyyy ($3.11 in chips)
Seat 4: 007x2 ($5.20 in chips)
Seat 5: biv12 ($4.47 in chips)
Seat 6: HATERS1337 ($5.46 in chips)
Pechkin85: posts small blind $0.02
Myrryyyy: posts big blind $0.05
*** HOLE CARDS ***
Dealt to Baksojor [9h Ts]
007x2: folds
biv12: folds
HATERS1337: folds
Baksojor: raises $0.05 to $0.10
Pechkin85: calls $0.08
Myrryyyy: calls $0.05
*** FLOP *** [9c Td As]
Pechkin85: checks
Myrryyyy: checks
Baksojor: bets $0.21
Pechkin85: raises $0.47 to $0.68
Myrryyyy: folds
Baksojor: calls $0.47
*** TURN *** [9c Td As] [5h]
Pechkin85: checks
Baksojor: bets $1.15
Pechkin85: folds
Uncalled bet ($1.15) returned to Baksojor
Baksojor collected $1.59 from pot
Baksojor: doesn't show hand
*** SUMMARY ***
Total pot $1.66 | Rake $0.07
Board [9c Td As 5h]
Seat 1: Baksojor (button) collected ($1.59)
Seat 2: Pechkin85 (small blind) folded on the Turn
Seat 3: Myrryyyy (big blind) folded on the Flop
Seat 4: 007x2 folded before Flop (didn't bet)
Seat 5: biv12 folded before Flop (didn't bet)
Seat 6: HATERS1337 folded before Flop (didn't bet)


*********** # 190 **************
PokerStars Zoom Hand #174048940302:  Hold'em No Limit ($0.02/$0.05) - 2017/08/07 23:44:42 MSK [2017/08/07 16:44:42 ET]
Table 'Donati' 6-max Seat #1 is the button
Seat 1: grant8064 ($5 in chips)
Seat 2: Baksojor ($17.28 in chips)
Seat 3: goldbunnies ($5.59 in chips)
Seat 4: Osiris7567 ($7.78 in chips)
Seat 5: FINTIFLYSHKI ($4.62 in chips)
Seat 6: chraeder ($3.39 in chips)
Baksojor: posts small blind $0.02
goldbunnies: posts big blind $0.05
*** HOLE CARDS ***
Dealt to Baksojor [2c Ts]
Osiris7567: raises $0.15 to $0.20
FINTIFLYSHKI: folds
chraeder: folds
grant8064: calls $0.20
Baksojor: folds
goldbunnies: folds
*** FLOP *** [7s Kh 9c]
Osiris7567: bets $0.30
grant8064: calls $0.30
*** TURN *** [7s Kh 9c] [Th]
Osiris7567: bets $0.69
grant8064: calls $0.69
*** RIVER *** [7s Kh 9c Th] [Ac]
Osiris7567: checks
grant8064: bets $3.81 and is all-in
Osiris7567: calls $3.81
*** SHOW DOWN ***
grant8064: shows [Td Jc] (a pair of Tens)
Osiris7567: shows [Kc Ah] (two pair, Aces and Kings)
Osiris7567 collected $9.65 from pot
*** SUMMARY ***
Total pot $10.07 | Rake $0.42
Board [7s Kh 9c Th Ac]
Seat 1: grant8064 (button) showed [Td Jc] and lost with a pair of Tens
Seat 2: Baksojor (small blind) folded before Flop
Seat 3: goldbunnies (big blind) folded before Flop
Seat 4: Osiris7567 showed [Kc Ah] and won ($9.65) with two pair, Aces and Kings
Seat 5: FINTIFLYSHKI folded before Flop (didn't bet)
Seat 6: chraeder folded before Flop (didn't bet)


*********** # 191 **************
PokerStars Zoom Hand #174048934992:  Hold'em No Limit ($0.02/$0.05) - 2017/08/07 23:44:35 MSK [2017/08/07 16:44:35 ET]
Table 'Donati' 6-max Seat #1 is the button
Seat 1: biv12 ($4.47 in chips)
Seat 2: Mak.Alse ($5.02 in chips)
Seat 3: AKKbank ($6.60 in chips)
Seat 4: Memusik ($5.42 in chips)
Seat 5: Levmachinexx ($6.94 in chips)
Seat 6: Baksojor ($17.28 in chips)
Mak.Alse: posts small blind $0.02
AKKbank: posts big blind $0.05
*** HOLE CARDS ***
Dealt to Baksojor [Ac 2d]
Memusik: folds
Levmachinexx: raises $0.10 to $0.15
Baksojor: folds
biv12: folds
Mak.Alse: raises $0.35 to $0.50
AKKbank: folds
Levmachinexx: calls $0.35
*** FLOP *** [5d Ts 6h]
Mak.Alse: checks
Levmachinexx: checks
*** TURN *** [5d Ts 6h] [As]
Mak.Alse: checks
Levmachinexx: checks
*** RIVER *** [5d Ts 6h As] [2c]
Mak.Alse: checks
Levmachinexx: checks
*** SHOW DOWN ***
Mak.Alse: shows [Jc Tc] (a pair of Tens)
Levmachinexx: mucks hand
Mak.Alse collected $1.01 from pot
*** SUMMARY ***
Total pot $1.05 | Rake $0.04
Board [5d Ts 6h As 2c]
Seat 1: biv12 (button) folded before Flop (didn't bet)
Seat 2: Mak.Alse (small blind) showed [Jc Tc] and won ($1.01) with a pair of Tens
Seat 3: AKKbank (big blind) folded before Flop
Seat 4: Memusik folded before Flop (didn't bet)
Seat 5: Levmachinexx mucked [9c 9h]
Seat 6: Baksojor folded before Flop (didn't bet)


*********** # 192 **************
PokerStars Zoom Hand #174048931789:  Hold'em No Limit ($0.02/$0.05) - 2017/08/07 23:44:31 MSK [2017/08/07 16:44:31 ET]
Table 'Donati' 6-max Seat #1 is the button
Seat 1: dudernr1 ($5.18 in chips)
Seat 2: plasencia345 ($5.64 in chips)
Seat 3: PayForSee ($8.48 in chips)
Seat 4: Sviat47 ($7.41 in chips)
Seat 5: Baksojor ($17.28 in chips)
Seat 6: biv12 ($4.47 in chips)
plasencia345: posts small blind $0.02
PayForSee: posts big blind $0.05
*** HOLE CARDS ***
Dealt to Baksojor [7c 2h]
Sviat47: folds
Baksojor: folds
biv12: folds
dudernr1: folds
plasencia345: folds
Uncalled bet ($0.03) returned to PayForSee
PayForSee collected $0.04 from pot
PayForSee: doesn't show hand
*** SUMMARY ***
Total pot $0.04 | Rake $0
Seat 1: dudernr1 (button) folded before Flop (didn't bet)
Seat 2: plasencia345 (small blind) folded before Flop
Seat 3: PayForSee (big blind) collected ($0.04)
Seat 4: Sviat47 folded before Flop (didn't bet)
Seat 5: Baksojor folded before Flop (didn't bet)
Seat 6: biv12 folded before Flop (didn't bet)


*********** # 193 **************
PokerStars Zoom Hand #174048926253:  Hold'em No Limit ($0.02/$0.05) - 2017/08/07 23:44:24 MSK [2017/08/07 16:44:24 ET]
Table 'Donati' 6-max Seat #1 is the button
Seat 1: Mastermuzzz ($5 in chips)
Seat 2: bajinege ($8.47 in chips)
Seat 3: Baksojor ($17.33 in chips)
Seat 4: rhysreece ($9.88 in chips)
Seat 5: ptolemaios99 ($16.12 in chips)
Seat 6: Mampflord ($6.24 in chips)
bajinege: posts small blind $0.02
Baksojor: posts big blind $0.05
*** HOLE CARDS ***
Dealt to Baksojor [7h 4d]
rhysreece: folds
ptolemaios99: raises $0.10 to $0.15
Mampflord: folds
Mastermuzzz: folds
bajinege: folds
Baksojor: folds
Uncalled bet ($0.10) returned to ptolemaios99
ptolemaios99 collected $0.12 from pot
ptolemaios99: doesn't show hand
*** SUMMARY ***
Total pot $0.12 | Rake $0
Seat 1: Mastermuzzz (button) folded before Flop (didn't bet)
Seat 2: bajinege (small blind) folded before Flop
Seat 3: Baksojor (big blind) folded before Flop
Seat 4: rhysreece folded before Flop (didn't bet)
Seat 5: ptolemaios99 collected ($0.12)
Seat 6: Mampflord folded before Flop (didn't bet)


*********** # 194 **************
PokerStars Zoom Hand #174048923058:  Hold'em No Limit ($0.02/$0.05) - 2017/08/07 23:44:20 MSK [2017/08/07 16:44:20 ET]
Table 'Donati' 6-max Seat #1 is the button
Seat 1: boksiukas ($5.28 in chips)
Seat 2: zarmik1986 ($4.28 in chips)
Seat 3: Misha250595 ($7.19 in chips)
Seat 4: fryspigs ($14.63 in chips)
Seat 5: Baksojor ($17.33 in chips)
Seat 6: Scar_spb ($5.09 in chips)
zarmik1986: posts small blind $0.02
Misha250595: posts big blind $0.05
*** HOLE CARDS ***
Dealt to Baksojor [3d 9d]
fryspigs: calls $0.05
Baksojor: folds
Scar_spb: folds
boksiukas: folds
zarmik1986: folds
Misha250595: checks
*** FLOP *** [Ad 4s Ks]
Misha250595: checks
fryspigs: bets $0.05
Misha250595: folds
Uncalled bet ($0.05) returned to fryspigs
fryspigs collected $0.12 from pot
fryspigs: doesn't show hand
*** SUMMARY ***
Total pot $0.12 | Rake $0
Board [Ad 4s Ks]
Seat 1: boksiukas (button) folded before Flop (didn't bet)
Seat 2: zarmik1986 (small blind) folded before Flop
Seat 3: Misha250595 (big blind) folded on the Flop
Seat 4: fryspigs collected ($0.12)
Seat 5: Baksojor folded before Flop (didn't bet)
Seat 6: Scar_spb folded before Flop (didn't bet)


*********** # 195 **************
PokerStars Zoom Hand #174048918413:  Hold'em No Limit ($0.02/$0.05) - 2017/08/07 23:44:14 MSK [2017/08/07 16:44:14 ET]
Table 'Donati' 6-max Seat #1 is the button
Seat 1: Sunny-Shanse ($4.86 in chips)
Seat 2: Baksojor ($17.35 in chips)
Seat 3: felipe_anps ($14.28 in chips)
Seat 4: boksiukas ($11.15 in chips)
Seat 5: Droncha ($15.39 in chips)
Seat 6: Teflonmemory ($7.48 in chips)
Baksojor: posts small blind $0.02
felipe_anps: posts big blind $0.05
*** HOLE CARDS ***
Dealt to Baksojor [5s Qc]
boksiukas: folds
Droncha: raises $0.10 to $0.15
Teflonmemory: folds
Sunny-Shanse: folds
Baksojor: folds
felipe_anps: folds
Uncalled bet ($0.10) returned to Droncha
Droncha collected $0.12 from pot
Droncha: doesn't show hand
*** SUMMARY ***
Total pot $0.12 | Rake $0
Seat 1: Sunny-Shanse (button) folded before Flop (didn't bet)
Seat 2: Baksojor (small blind) folded before Flop
Seat 3: felipe_anps (big blind) folded before Flop
Seat 4: boksiukas folded before Flop (didn't bet)
Seat 5: Droncha collected ($0.12)
Seat 6: Teflonmemory folded before Flop (didn't bet)


*********** # 196 **************
PokerStars Zoom Hand #174048915291:  Hold'em No Limit ($0.02/$0.05) - 2017/08/07 23:44:10 MSK [2017/08/07 16:44:10 ET]
Table 'Donati' 6-max Seat #1 is the button
Seat 1: Girigal ($5.10 in chips)
Seat 2: sevenovici ($16.17 in chips)
Seat 3: Majkee88 ($5.17 in chips)
Seat 4: Baksojor ($17.35 in chips)
Seat 5: AndreyK11 ($11.37 in chips)
Seat 6: Sunny-Shanse ($4.86 in chips)
sevenovici: posts small blind $0.02
Majkee88: posts big blind $0.05
*** HOLE CARDS ***
Dealt to Baksojor [8d 4h]
Baksojor: folds
AndreyK11: folds
Sunny-Shanse: folds
Girigal: raises $0.07 to $0.12
sevenovici: folds
Majkee88: folds
Uncalled bet ($0.07) returned to Girigal
Girigal collected $0.12 from pot
Girigal: doesn't show hand
*** SUMMARY ***
Total pot $0.12 | Rake $0
Seat 1: Girigal (button) collected ($0.12)
Seat 2: sevenovici (small blind) folded before Flop
Seat 3: Majkee88 (big blind) folded before Flop
Seat 4: Baksojor folded before Flop (didn't bet)
Seat 5: AndreyK11 folded before Flop (didn't bet)
Seat 6: Sunny-Shanse folded before Flop (didn't bet)


*********** # 197 **************
PokerStars Zoom Hand #174048899670:  Hold'em No Limit ($0.02/$0.05) - 2017/08/07 23:43:50 MSK [2017/08/07 16:43:50 ET]
Table 'Donati' 6-max Seat #1 is the button
Seat 1: Baksojor ($17.35 in chips)
Seat 2: BennyPasta ($4.36 in chips)
Seat 3: dark h0r$e ($5.25 in chips)
Seat 4: win56987 ($7.04 in chips)
Seat 5: My4Street ($6.10 in chips)
Seat 6: 1matodor$ ($6.06 in chips)
BennyPasta: posts small blind $0.02
dark h0r$e: posts big blind $0.05
*** HOLE CARDS ***
Dealt to Baksojor [3h Jh]
win56987: folds
My4Street: folds
1matodor$: raises $0.06 to $0.11
Baksojor: folds
BennyPasta: folds
dark h0r$e: folds
Uncalled bet ($0.06) returned to 1matodor$
1matodor$ collected $0.12 from pot
1matodor$: doesn't show hand
*** SUMMARY ***
Total pot $0.12 | Rake $0
Seat 1: Baksojor (button) folded before Flop (didn't bet)
Seat 2: BennyPasta (small blind) folded before Flop
Seat 3: dark h0r$e (big blind) folded before Flop
Seat 4: win56987 folded before Flop (didn't bet)
Seat 5: My4Street folded before Flop (didn't bet)
Seat 6: 1matodor$ collected ($0.12)


*********** # 198 **************
PokerStars Zoom Hand #174048890978:  Hold'em No Limit ($0.02/$0.05) - 2017/08/07 23:43:39 MSK [2017/08/07 16:43:39 ET]
Table 'Donati' 6-max Seat #1 is the button
Seat 1: bigamus ($6.14 in chips)
Seat 2: lucky_gabbi ($4.60 in chips)
Seat 3: Swing1025 ($7.57 in chips)
Seat 4: chraeder ($2.08 in chips)
Seat 5: goldbunnies ($5.10 in chips)
Seat 6: Baksojor ($17.35 in chips)
lucky_gabbi: posts small blind $0.02
Swing1025: posts big blind $0.05
*** HOLE CARDS ***
Dealt to Baksojor [8c 6s]
chraeder: raises $0.07 to $0.12
goldbunnies: folds
Baksojor: folds
bigamus: folds
lucky_gabbi: folds
Swing1025: folds
Uncalled bet ($0.07) returned to chraeder
chraeder collected $0.12 from pot
chraeder: doesn't show hand
*** SUMMARY ***
Total pot $0.12 | Rake $0
Seat 1: bigamus (button) folded before Flop (didn't bet)
Seat 2: lucky_gabbi (small blind) folded before Flop
Seat 3: Swing1025 (big blind) folded before Flop
Seat 4: chraeder collected ($0.12)
Seat 5: goldbunnies folded before Flop (didn't bet)
Seat 6: Baksojor folded before Flop (didn't bet)


*********** # 199 **************
PokerStars Zoom Hand #174048879804:  Hold'em No Limit ($0.02/$0.05) - 2017/08/07 23:43:25 MSK [2017/08/07 16:43:25 ET]
Table 'Donati' 6-max Seat #1 is the button
Seat 1: StephBpee ($3.08 in chips)
Seat 2: dudernr1 ($5.11 in chips)
Seat 3: Baksojor ($17.33 in chips)
Seat 4: 7shun7 ($2.65 in chips)
Seat 5: KAKIxBARRY ($5.33 in chips)
Seat 6: Myrryyyy ($2.48 in chips)
dudernr1: posts small blind $0.02
Baksojor: posts big blind $0.05
*** HOLE CARDS ***
Dealt to Baksojor [4c As]
7shun7: folds
KAKIxBARRY: folds
Myrryyyy: folds
StephBpee: folds
dudernr1: folds
Uncalled bet ($0.03) returned to Baksojor
Baksojor collected $0.04 from pot
Baksojor: doesn't show hand
*** SUMMARY ***
Total pot $0.04 | Rake $0
Seat 1: StephBpee (button) folded before Flop (didn't bet)
Seat 2: dudernr1 (small blind) folded before Flop
Seat 3: Baksojor (big blind) collected ($0.04)
Seat 4: 7shun7 folded before Flop (didn't bet)
Seat 5: KAKIxBARRY folded before Flop (didn't bet)
Seat 6: Myrryyyy folded before Flop (didn't bet)


*********** # 200 **************
PokerStars Zoom Hand #174048876704:  Hold'em No Limit ($0.02/$0.05) - 2017/08/07 23:43:21 MSK [2017/08/07 16:43:21 ET]
Table 'Donati' 6-max Seat #1 is the button
Seat 1: nitzed12 ($6.10 in chips)
Seat 2: Baksojor ($17.35 in chips)
Seat 3: kingme698 ($1.11 in chips)
Seat 4: IldarD86 ($5 in chips)
Seat 5: fam007007 ($7.35 in chips)
Seat 6: andypr0 ($5.85 in chips)
Baksojor: posts small blind $0.02
kingme698: posts big blind $0.05
*** HOLE CARDS ***
Dealt to Baksojor [4c Td]
IldarD86: raises $0.05 to $0.10
fam007007: raises $0.15 to $0.25
andypr0: folds
nitzed12: folds
Baksojor: folds
kingme698: calls $0.20
IldarD86: calls $0.15
*** FLOP *** [8c 7s Jc]
kingme698: bets $0.86 and is all-in
IldarD86: folds
fam007007: folds
Uncalled bet ($0.86) returned to kingme698
kingme698 collected $0.74 from pot
kingme698: doesn't show hand
*** SUMMARY ***
Total pot $0.77 | Rake $0.03
Board [8c 7s Jc]
Seat 1: nitzed12 (button) folded before Flop (didn't bet)
Seat 2: Baksojor (small blind) folded before Flop
Seat 3: kingme698 (big blind) collected ($0.74)
Seat 4: IldarD86 folded on the Flop
Seat 5: fam007007 folded on the Flop
Seat 6: andypr0 folded before Flop (didn't bet)

